**********
*XXXXXX*XX
*X********
*X*XXXXXX*
*X*X******
***XXXXXX*
*X****X*XX
*XX*X*****
*X**XXXXX*
***XXXXXX*