*********
*XXXXX*XX
*X*******
*X****XX*
*********
******XXX
**X******
*XX*X*XX*
*XX*X*XX*
****X****