**********
*XXX*XXXX*
*X******X*
*X******X*
*XXXXXXXX*
**********
