*X*X*X****XX***X****X****X**********X*****X*****X****X*X**XX*******X*****XX*X******X*X********X******X**X***X*********X*X**X********X*****X****X****X*****X**X**X*****X****XX***X****X*XX*X**X
*X*****XX****X**XX*X**X*X**XXX*XX*XX**XXX***XXX*X*X*X****X***X*X*XX**XXX****X*X*XX***X*X*XX*X*X*XXXX**X***X*X*X*XXX*X*X***X**XXX*XX**XX*X**X*X**XXX***X*X***X**X**X*X***XX***XX**X*X*X******XX
*X*XX*X**X*XX*X*XX***X**X*X****XX****XX**XXX**X**X**X*XX***X*X**X***X***XX*X**X*X**X*X*X*X***X**X****X*XX*X****X****X**XX***X****X*X*X**X*XX**X****X*XX**XX*X*X**X*X*XXX**XX***X***X*XXX*XX**X
*X*XX**X*XX***X****XX**X*X**X*X**XX*X***X***X**X**X*****XXXX*X*X**XXX*X*X***X*X**X**X**X**X*X*X**XX*X****XX*XXX**XXX*X***XXX**XXX**X***XX***X**XXX**X***X*X*X***XX******X*X*XX**X*XX***X*XXX*X
*X***X*X****XX**XXX***X****XXX**X**X**X**X*X**XXX**X*X*X****XX**X*X***X**XX*X**X*XXXX*X**X**X**X*X***X*X***XX***X****X*XX****XX***X*X*XX*XX**X*X**X*XX*X**X***XX***XXXX*******X*X*X**X*X**XX*X
*X*X*X**X*XXX**X***X*XX*XX**X**X*X***X*X*****X*X*X*X**X**XX*X**X**XXX**X**X**X*X******X*X*X**X*X*X*X*X**XX*X**XX*X*X*X****XXX***X****X*****X****X*X**X**X**XXX*X*XX****X*X*X*X**X*X*X***X***XX
****X*X*X*****X**X*X***XX*X*X*X****X*X**XXXX*X***X*XX**X*X****X*X****X**X*X*XX**X*XXX*X****XX**X**X**XX**X***X*X**X***XX*X***X*XXX*X**X*XX**XXXX***X**X*XX***X*X*XXXXX**X**XX**X***X**X**XX**X
XXX***X*X*X*XXXX*X**XX******X*XX*X*X***X******XX*X**X*X**X*XX****XXX*XXX**X****X*X***X*XXX***X**X**X****X*XXX***X***XXXX**X*X***X**X*X****X*X****X**X*X***XX***X**X****XX*X***X**X**XXXX*X*X*X
***XXX**XX****X***X***XXXX*X*****X**XXX**XX*X****XX*X*X*X*X*X*XX*X*****X*X*XXXX****X*X****XX**X*X*X*XXX*X*****X*X*X***X**X**X*XX**X***XXX*X**XX*X*X*X**XX*X**X*X*X**X*XX**X*XXX*X*X***X****X*X
*X*****X***XXXX*X**XX*X*****X*X*X**X***X***X*X*XX***XX**X***X**X**X*XX*****X***XX*XX***X*X**X*X***X****X**XXXX**X*X*X**XX**X**X**X**X*X****X****X****X**X**XX******X*X***XX*X***X**XX*XX*X*X*X
*XX*XXX**XX******X**X**XXXXX**XX*X***X*XXXX***X***XX***X*X*X*X**X**X**X*X*X**X****X*X*X****XX**X*X*X*XX**X****X*X**X*X****X**X**X**XX*X*X*X**XXXXXXXX*X**X***X*X*X*X***XX***X*X***XXX***X**X*X
***X***X*X**XXXX*XXX*X*X****X*****X*X*****X*X***XX***XX******XX**XX**X*X**XX*XX*XX***X**X*X***XXX*****X*X**XX****X****X*X*X*XXX*X*XX**X**X**X***X******X**XX**X***XX*XXX**XX*X**X**X*XX*X*X**X
*X***X**X**X****X****X***XX**X*XXX**X*XXX*X*X*XX***XX***XX*X***X****XX***X****X*X**XX**XXX**X**X**XXX*X*X*XX**XX**X*X*X*XX***X**XXX**X*X*XX*X*X***XX*XX*X**X*X**XX***X***XX***XX*X****X*X***XX
*X*XX**X**X*X*X*X*XX**X*X***XXX***X**X**X****X***XX*X*XX*X**XX**XX*X***XX*XXXX**X*X***X*X**XXX*X*X****X*X***X**XXX**XXX**X*X**X****X*X*****X***XXX*******X*X**X*X**X*X*XX***X*****XXX*X*X*X**X
*X*X**X*X*X***X*X*X*X**X**X*XX**X**X**X**XXX**X*X***X*****X**XXX***X*XX*******X*X**X*XX***X*X**X*X*X*X***XX**XX****X***X****X*XXXX*X*XXX*X**XX****XXXX*X*X**X**X**X**X**XX*X*X*XX*X***X**XXX*X
**X**X*****X*XXX**X**X***XXX***X**X*X**X***X*X**X*XXXXXX*X*X***X*XX**XX*XX*XX****X***X**XXX*X*X**X**X**XX**X**X*XX*X*X**XXXXX****X*X****X*X**X*X*X***X**X*X*X*X**XX*XXX***X**X**X**XX**X**X**X
X**X**X*X*X***X**X*X*X*X*XX**X*X*X***X***XX***X*X***X**X****XX*****X***X****XXX*X*X*X**X****X*X*X*X*X*X***XXX*****XX**X******XX*XX**XXX*X**X*X**X**X*XX***X*X*X*X***XX*XX**X***X*X***X**X**XXX
XX**X**X***XX*X*XX******X***XXX**X*X***XXX**X***X*X***X*XXX***X*X*X*XX*X*XX****X***XX*X*X*XX**X***X*X***X*XX*X*X*X***X*XXXXX*XX***X***X***X***X*X*X***X*X*X*X*X**X*X***X*X***XX***XX*X*X*X***X
X*XX*X*X*X****X***XXXXX*X*XX*X**XX*XXXX***X*XXXX***X*X**X**XX**X*X*****X*X*XXX*X*X****X******X*X*X***X*XXX****XXX**XX**X***X***XX**XX**XX**X*X**X*XXX*XXX*X***XX*X***X****XXX**XX****X****XX*X
*****X*X**X*X*X*X******XX**X**X***X*****X**X***XXXX***X***X**X***X*XX*X*X******X**XX*X**X*X*XX**X**XX***X**XX**X**X*XX***X*X*X***XX*X*X*XX*X*X*XX***X******X*X***X*XX*X*X*X**X****XXX*XX*X*X*X
*X*X****X**X***X*X*XXX***X**X**XX***X*XXX*X**X*****XX**X*X**X**XX**X*X****XX*X*XX*X*X**X*X*X***XX*X***X*X*X**X***X*****XXX****XX******X******X***XX*XXXX*X*X*X*X**X***X**X**XX*XXXX********X*X
*XX*XXX*XX**X*X***X***X*XXX*XX*X*XXX*X****X*XXXXXX***X****X*XX**X*X****XX*X*XXX***X**X*X*****X****X*XX*X**XX**X*X**X*XX***XXX**XXXX*XX**X*XX**XX**X*****X***X***X***X**X*X*X***X****X*X*X*XX*X
*X****X***X**X**X*X*X*X*XXX**X***X*****XXX**XX****XX**X*X******X**X*X*XX*X***X**XX*X*X*X*X*X**X*XX**XX*X*X***XX**XX*X***X****XX****X*X*X*X*XX***X**XX*X**XXX**X**XXX**XX***X*XX**XXXX**X*X***X
*X*XX**XX**X***XX***X*X**X*X*X*X*X*XX*X****X***X*X**X*X**X*XXX*X*XX**X***X*X***X*****X*X**X*X**X***X***X**X*X***X***X*XX*XXX*X**XX*X***X****X*X*XX***X*X****X*XX***X*XX**XXX*X**XX***XX****X*X
***X**X**X*XX*XX*X*X**XX*****X*X*X*X**X*XXX**XX****X**XX**X***X**X**X**X***X*XX*X*XX*X**X***X*X**XX**XX*X*X*X*XX**X*X**X*X*X**X**X*X*XXX*XX**X*X***X***XXXX*X**XX*XX*X**X****X*X***X*X**XXX**X
*XXX*X**X***XX****X*X***X*XXX*X**X*X*X**X**X*X**XX**X***X*X*X*X*XX*X*X**XXXXX***X**X*XX**X*X**X*XX**X*****X****X*XX***X*****X***X**X*X***X*X*X***XX*X*X***X**X**XX***X*X**XXXXX**XX***X***XXXX
X****X*X**X****XX*X*X*X**X******X***X**XXX***X*X**X**X*X*****X**X*****X****X**X***X****X**X**XX*X**X**X*XXX*XXX**X*XXX**XXX**XXX**XXX**X***X***XX***XX**X***XX*X***X**X**XX**X**XXX*XX**X****X
**X*X***X*X*XXXX**X**XXX*X*XXX*X**XX**X*X*XXX**X*X*X*X*X*XXXX**X**XXX**XXX**XX*X*XX*X*X**XX*X***X*X*X**X******X*X*****X****X*X**X**X**X**XX*XXXX**X**X*X**XXX**X*X**XX**XX**X**X*X**X**X*XXX*X
X*XXXX*X***X****X**X**X***XX***XX****X******X*XX***X*X**X*****XXX***XX****X****X*X***XX*X***X*XX*****X*X*X*XXXX**X*X*X*XX*X**X*X*X***XXXX********X*X***X*X****X***XX***X***X**X**X*X*XX******X
****XX***XXX*XX**X**X*X*XX***X***XXXX*X*XXX***X**XXX**X*X*X*XX*XX*X***X*X**X*X*X**X*X***X*XXX***X*XX*X**X**X***X**X*******X*XX****XX*XX***XX*XXX****X*X**X*XXX*XX****XX*X*X**X*X*X*X**X*XXXX*X
*XX***X*X****X**X**X**X*X**XX*XX*X**X***X**XXX**X****X**X**X******XXX**X*X*XXX**X*X*X*X*X****XX*X*XX**X*X*XX*X*X*X**XXXXXXX***XX*X**X***X**XX***X*X**X**XX*X*****XXXX*******X****X**X******XXX
*X*XX*X*X*X*X*X*X*X**XX***X****X**X***XXXX*X*XX*X*X*X**X*X*X*XXXXX***X****X****X**XX***X**XX**X*X***XXX**XX**X*X*X*X*******XX**X***X**XX**X***X*XXX*X**X***X*X*X*****X*X*X*X**X*XXX*X*XXXX***X
****X*X*X**X**X*X***X**XXX**XX**X**XX*X*XX****X*X**X**XX***X*X*****X*X*X*X**XX*XX**X*X**XX*X*XX**XX*X***X***XX***X**X*X*X*X**X*X*X**X***XX**XXX****X**X**XXXX*X*X*XX**XX**XX*X***X**X*****XX*X
X*X*X*X**X*X*X**X*X*X*X****X***X**X***X****XX***XX*X*XX**XXX*X*XXXX**XX***X*X****X****X*X******X*XX*X*X*X*XX**XXX*X**X**X*XX*X***X*X*XX****X***XXX**X**X***X****X***X***X***X**X***X*XX*X*X**X
*XX*X**X*X*X**X**X****X*XX*X*X*X*X**XX**XXX**X*X***X****X***X**X***X****X*X*XX*XXX*XXX****XX*XXX****X*XX**X*X*X*X**X*X*X***X*XXXX**X*X*XX*X**X***XX**X**XX*X*XX**X*X*XX*X*X**XX**X*X***XX**X*X
*X***X**X***X**X*XXXXX****XX**XX*X*X**X*X***X**X*XX*XXXX**X***XX*X**XXXX**X***X***X***XXXX*XX***XXX*X**X*X********X**X**XX******X*X****X*X**X**X**XX*XXXX****X*X***X**X*XX*X*X**X****X***XXX*X
***X**X***X***X********XX***X*******X*****X**X***********XXX*X****X******X**X***X***X*********X******X*****XX*X*X***XXX***X*X*X*****XX*****X**XXX**X******X*X****X**X********X*X**X*X**X******
