****X*XXXXX***X***X******X******XX***X*X***X*******X***X**X*X***X****X******X******X*******X***XX**X*X*X**X****X*********X********X****X****XXXX***X*****X******X***X*X*****X***X*********X**X
X*XX***XXX**X***X***XXXX*XXX*XX****X*X*X*X**X*X*XX*X*X***X***XX***XXX**XXX*X**XXXX***XX*XX**XX****X*****X***X*X**XXX*X*X***XXXX*X**XX*X**XX**XX**X**X*XX***XXXX***X****X*XX***X**XX*XX*XX*XX*X
X****X**X**X*X*X**XX***X****XX*X*XX**X*X**X***X***X***X*X**X****X*****XX*X***X****XXX*X***XX***X*X**X*X*X*X**X**X***X***XXX***X**X****X*X*XX****X*X**X***XX****XX**XXX**X***XXX*X***X**XX****X
**XXXXX*X*X**X**XX***XX*X*X****X***X****X**XXX**XX**XXX**X**XXXX*XXX*XX***XXX**XX*X*X**XX****XXX***X**X***X*X**XX*X**XX*X***X**X**XXXX**X***XX*X***X***X*XX*XX**X*X***X***XX****X*XX**X**XXX*X
*XX**XX***XX**X***XX*******X*X*X*X*XX*XX**X***X****X****X**X***X****X***X***XX**X*X***X**XXXX***XXX**XX*X**X**XX**XX*X***X*XXX*X*X****X*X*X***X**X*XXX*XX***XXX**X**X***X***X*XX**X*X**X***X*X
***X***X*X*XX**XX***X*XXXXX*X***X***XX***X**XX*XX*XX*X*X**X*X*XX*XX***X**XX***X*X**X*XX*X*****X****X*X***XX**XX**X*X*XX*X***X**X*X*XX****X**X***X****X****XX*X**X**XXXXX*X*X***X*X***X*X*XX**X
XX*X*X*X*X****X**XX**X*******XX**XX**X*XX*X*X****XX**XXX*X****X**X*XX*XXX***X***X*X******X*XXX**XXX**XXXX***X***X**X****X*X*X*X**X**XXXX*X*X*X*X**XXX*XXXX***X*X*X**X*****X**X*X***X*X*X*X**XX
*X**X***X**X*X**X***XX*XXXXX***X*XXX*X**X***X*XX****X****XXX*X**X***X****X*X*XXX****XX*X*XXX***XX***X***X*X*X*X**X*X*XXX*X**XX**X*X*****X**X*XXXXX*********XXX****X*X*XXX**XX*X*XX**X**X**X**X
**X*X*X**X*X***X**XX***X****XX*X**X**XX*X*X*X**XX*X*X*XXX****X*X**X**XXX**X*****XX*X**XX*****XX***X*X*X*X*X*X*XXX***X**X***X***X***XXXX*X*X****X***XXXXXXX****XXX**XX****X*******X*X**X*X*X*XX
*X**X**X**X*X*X*X*XX*XX**XXX*X**X***X***X**X*X***XXXX*X*X*X*X***X**X****X*X*X*X**XX*X***XX*X**X*X*X*X*X*X**XX****XX***X**X*X*XX**X****X*X***XX***XX*******XX*X***X****X*X*XX*XXX****X*X******X
***X*X**X*******X****X*X*X****X**XX*X*XX*X****XX**X***X***X*X*XX**X*X*X*X*X*XX**X****XX*****X*X**X**X*X**X***XXX*X*X*X**XX****X*X*X*X*X**X*X**XXXX**XX*X*X*****X**X*XX*X****X***XXXX***XXX*X*X
*XX***X**X*XX*XX*XXXX******X*X*X*X*X**X***X*X*X*X***XX*X*XX*X***X*X**XX*X****X*X**XX***XX*X**XXX**XX**XX*XXX***X*X*X*X*X**XXX*X*X*X*X**X*X***X*****X***XX**XXXX*X**X*****XX*X*X******XX***X**X
**X*X**X*X**X****X***X*X*XX****X***X*X*X*X**X****XXX***X***X*XX***X*X****XXXX***X*X*XX***X*X**X*X*X**X*X****X*X**X***X**X****X****X**X*X**XX*X*X*XXX*XX*X*XX*****X*X*X*X*X**X*XX*XXX*X**X**X*X
X**X**X**X*X**XX***X**X***X*XX**X*X**X*****X*XXX*****X**XX****XXXX**X*XX*X***X*X******XX*X*XX*X*X***X***XXX*X**X**X*X*X*XX*XX**X*X*X**X**X*X****X****X**X*X**X*XXX**X**X**X*X**XX**X*X*X*XX**X
XX**X***X**X*X**XXX*X*X*X*X***X*X**X*XX*XXX*****XX*XXXX*X**XX******X****XX*X*X***XXX*X*X*X****X**XXX**X***X*X*X**X****X****X**X*X***X*X*X***XXXX**XXX**X**X*X*X****X**XXX*X*XX***X***X*X*X**XX
X**X**X*X*XXX**X****X*X**X*X*XX**X****X*X*X*X*XXX*X**X**X*X**X*XXX*X*X*X***X**XXX***X****X*XXX*X*X**XX**X*X***X*X*X*X**XX*X**X**X*X***X*X*XXX****XX***X*X*X***X*X*X*X**X**X***XX**X*X**X*X*X*X
**X*XX*XX**X**X**X*XX*X*X****X**X*XXXX**X***X*******X**X****X**X***X*XX**XXX*X****X***XXXX***X****X****X***XXX**X***XX*X***X*X*X***XXX**X*X***XX****X*X***X*X*X**X****X**X*X*X***X***X*X*****X
*XX*******X**X**XX*X***X**XXX*X***X****X*XXX*X*X*X*X**XX*XX*XXX**XX***X*X****X*XXX*XXX****XX***XX***XXX**XX***X*XX*X***X*X*X*X**X*X****X****XX**XXX**X**XX***X*X**X*XXX*X****X*XX**X*X*XX*X*XX
*X**XXXXXX**XX*X***X*XX**X*****XX*X*XXX*******X**XX**XX****X***X**X*X*X**XX*X**X*X*X***XX***XXXX*XXX**X*XX**X*X**X**XXXX*X*X**X*X*X*X*X**XXX***X***XXX*X***XX***X*X*X***X*X*XX**XXX**X***X***X
***XX*****X****X*X*X*X**XX*XX*X***X*X***X*XXX***X***X***X*X**X*X*XX**X*X*X**XX*X*****XXX*XX*X********X**X**X***X**X*******X**X**X***XX*X*X***X*X*X*****XXX****XX***X**XX**XX**X****XX*XX**XX*X
X*XX**XXX**X*X*X*X*X***X***XX**X*XX**X*X**X***XX**X**XXXX*X*X****X**X****X*X***X*XX*XX***X**XXX*X*X*X*X*X*X*XXX**X**XXX*XX**XX*X*XXX***X**XX*X*X*XXXXXX***XX*XX**XX**X**X****X*X*X******X***XX
*X***X***X*X*XX**X**XXX*X*X**X*X***X*XX**X**XX***X*XX****X**XXX*X**X**XXXX***XXX**X*X**XX**X****X**X****X*****X*X**X***X*X*X*****X***XX**X***X*X******X*X**X*X**X***X*X**XXX****X*XXX*XX*XX*XX
***X*X*XX**X**X*XXX*X***X**X****XX*X***X*X*X***XX*****XX**X****X**X**X****XXX****X**X*XX**X*X*XX**X**XXX*XX*X*X*X*XX*X***X**X*X*X**X***X*X*XX*XXX*XXX***X*X**X*XXX*X***X****X*X***X***X**XX**X
*XX*X**X**X*X*X*XXX**X*X**X*X*X*X**X*X*X**X**XX***XX*X**X**X*X***XX*X*X*X*X***X*X**X**X**X****XXX**X***X***X**X*XX***XXX***X***X**X**X***X*****X*X***X*X**X*X**XX****X**X*X***XX*X**X***X***XX
*XX***X**X****X**X**X****X***X*X**XX*X*XX***X**XXX***X*X*X*X*XXXX***X***X**X*X**X*X**X**X**X*X*X*X**XX***X**X*X***X*X***XXX**X**X*X*X*X*X*XX*X*****X**X**X****X***X*X*X**X**XX**X**X*X*X**XX*X
*X**X***X**X*X*X*X*X*X*XXX*X***X*X***X**X*XX*X*****XXX***X*X*****X*X**XXXX*X*XXX***X**X*X*XX*X****X***XXX*X****XX*X*X*X****X**X*X**X***X****X**X*X**XXX*X**X*X*XX**X***X*X*X**X*X*X**XX**X***X
*XXX**X*X*XXX**X*X*X***X***XX*X**X*XXXX*X*X***X*X*X****X*X**XXX*X**XX*X*X***X***X*X**XX*X*X**XX*XX*XX*X****XX*X***X**X**XX*XXX***X***XX**XX*X*X**X*X****XX**X****X***XX**X**X***X***X***X**X*X
****XXX*X**X**X**X**XX*X*XX*X*X*X****X**X*XXX****X*XX*XX*X*X***XX*X***X***X***X*X*X*X****X**X*X****XX*X*XX**X**X*X**X**X*X****XX**XX****XXX**X**X*X**XXX**X**X*X***X*X**X*X**X*X*XX***XXXX*X*X
*XX****X*X*X*X**X*X*XX*X****X*X**XXX**X*X****XX*X*****X**X***X****X*X**X*X*XXX****X**X*X**X*X*X*XX****XX***X*X*X***X**X***X*X***X**X*XXX*X**X**X**X*XX***X*X**XX*X*XX**X***X******XX*X**XX*X*X
*XXXXX***X***X*X**X*****X*X*X**X*X**X*X**XXX****X*XXXX*X**X*X*XX*X**XX**X****XX*X**X**X*X***X*****XX*X*X*XX**X**XXX*X**XX****XX**X**X*****X*X*X**X**X**X****X***X***X*X**X**XXXXX***X*X****X*X
*XX**X*X**XX*X*XX**XX*X*XX**X*X**X*XX**X****XXXX**X*****X**X****X**X**X**X*X*****X**X****XXX**X*X***XX******XX*X****XX*XXXXXX**X*XX*X*XXX*******X*X*X*X*X*X*XXX**XX*X**X*X*X*****XX***XXX*X*XX
****X***X**X*X***X**X*XX***X***X*X****X*XXX*****X**X*X*XX*X**XX***X**X*X*X*X*XXX**X*X*XX*****XXX*XX***X*X*XXX**X*XX*****X****X****X***X**XXXXXX***X*X*X***XX***X***X*X*X**X**XXX**XXX***X****X
XXX**X*X**XX**XX**X****X*X*X*XXX**XXX***X**X*X*XX*X**XX***X*X**X*X**XX*X*X**X***X**X**X*X*X*XXX****XX*XX**X***X****XXXX***XX**X*X*X*X***XX*****X*XX*X**X*X***X**XX*****XX***XX***X***XX*X*XX*X
***X*X*XX***X*X**X*XXXX**X*X*****X***XX***XXX**X***X****XX***X**X**X***X**X*X*X**X**XX***X***X**XX*X*****X**XX*XXXX***X*XX**X*XX***XX*X*X**XXX**X***XX*X***XX*X***XXX*X***XX***XX**X**X**X***X
*X*X*X***XX*X*X*X******X**X*XX*XX**X***XXXXXX*X**X**XXXXX**X**X***X**X**X**X**XX**X**X*X*X*X*X*X*X*XXXXX**X*X*******X*X***X*X***XX*X**XX**X***X***XX***XXXX****XX***XX**XX*X*XX*X*X*X*XX*X*X*X
**X***XX***XX*X**XX*XX**X*X***XX**XX*X****XX***X**XX******X*X*XX*X**X*X*XX*X*X*X*X*XX**X**X*XX*X*X*****XXX***XXX*XXXX*XXXX***XX**X*XXX***X**X**XXX***XX***XXXX***X*X***XX**X****X*X*X**X*X*X*X
X***X***XX*****X******X*****X****X****X*X****X**X****X*X*X*********X*****X*****X******XXX*********X*XX*****X*****X*********X****X******XX**XXX*****X****X******X*X***X****X**XX******X*****X**
