*X*X***XX*****X****X*********X***XX*X***XX********X***X********X***X***X**X***X****X******X****X****X****X***X****X***X**X**********X***X*X***X**X*******X***X******X*X***X*X******X****X**X*X
*X***X****X*X*X*XX***XXXXXXX**XX******X****XX*XXX***XX**X*XX*X*X*X*X*X***X**X*X*XX***X*X*X**XX**X*X***XX*X*X*X*XX***X**X**X*X*XXXX*X**X***X*X**X***XXX*X***X*X*XX*XX***XX****X*X*X***XX**X***X
*X*X*X*XXX**XX**X*XXX*******X**XXX*XXX*XXXX**X***XX***X*X***XX***X*X*X*X*X*XX*X***X*X**X*X*XX*X***X*XX*X*X**X**X*XXX*X**X****X***X*X*X*X*X**XX**X*X***X*X*XX**X****X*X****XX***X**XXX**X**X*XX
**X***X***X**X*X****X*XX*X*X*X*****X***X****X**X***XX**XX*X*X*XXX**X**X****X**X*X*X*X*X**X*****X*X*X***X*XX*X*X*******X***XX*X*X***XXX*X***X**X*****X*X**X**X***XX*X**XXXX**XXX**X***X**X****X
X***X*X*X**X*X**X*X***X**X****X*XXX**XXX*XX***X*XX*X*X***X**X***XX**X*X*X*X**X*X*X**XX**X**X*XXX****XX*X**X*X*XX*X*XX**X*X*X*X**XXX*****XX***XXX*XXXX**X***X**XX**X**X****X****X***X*X*XXX*X*X
**X**XX*X*X**XX*X*X*XXX*X*XX*X**X**X*X*****XX***X*****XX*X*X**X***X*X**X*XX*X****X*X***X**XXX***X*X*X***X*X*****XX***X**X****X*X***X*XX*X*XX**X*X****X*XX*X**X***X**X**X*X**XX**X*X**X**XX**XX
X**X****X**X**X*X**X****X***X**X*X***X*X*X*X*XX**X*XX*X**X*X*XXX*X**XX*X******XX*X**X*XX*X*X**X**X**X*X*X*XX*XX*X**XX*XX**XXX**XXX****X*X***X****X*X*X**X***X**X*XX**X*X*X*X*XX**X*X**X***X**X
**X*XX*X*X**XXX**X**X*XX**X*X*X***X*XX**X**X*XXX*X*XXX**X**X**X***X**X*XXX*XXX*X**X**X*****X*X**XX*X***XX***X*****X******X***X****X*XX**XX*X*X*X*X**X*X**X*XX*XX***X*XX**X****XX*****X*X*X*X*X
*X****X***X****X*X*X**X**X**X***X*X***X**X*X**XX*X**XX*X*X*XX*X*XX*X*X****X*****X*XX***XXXX**X*X***X*X***XX*X*XXX*X*XX*XXX*X**XXX*X*X**X*****X*X**X****X**XX****X*XX****X*XXX**XXX*X***X*****X
***XX**X*XXXX*X**X**X***X**X*X*XX**XX**X**X*X***X*X****X*****XX****X*X*XX*X*XX*XX***X*X*****XX***XX***XX**X**X***X**X*X****XX*X*X***X*XXX*XX**X**X**X*X**X***XXX****XXX*X****X****XXXXX**XXXXX
X*X**X*X**X*X***X*X**X*X**X***X**X*X**X*X*X*XXX*X***XXX**XXX***X*XXX**X****X***X*XX*X**X*X*X**XXX**XX**XX*XX***X***X***X*XX*****XXXXX**X**X*X**X*X*X***X***XX****XX***X*XX*X**XXX**X***X*X***X
*XXX***XX****X*X***XX*X*X***X***X**X*X**X*X***X**XX***XX***XXX*X****X*XX*X*X*XX***X**X*X**X*X*X*XX***X**X***XXX*XXX**X**X***XX*X******X**X****X**XXX*X**X*X***X*X**X*X****XXX***XX***X**X**X*X
**X**XX**X*X*XX**X*******X*X**X*X*XX***X***XX**X*X*XX***XXX****X*XX*X***X**X****XX*X**XXX***X******X**X**XX********X**X***X*X*XX*X*XXX**X**X*X*X****XXX**X**XX*X*X****XXX*XXX*X***XXXXX*X*XX*X
X**X***X***X****X*XXXXXX***X*X*X**X**X*X*X****X**X***XX*****X*X**X***XX*X*X**X*X****X**X**X**X*X*XX**X*X**X*XXXXXX*XX**X*X*X*****XX***X*X*X*****XXX**X**X**X*******XX***X**X***X*XX**X**X*X**X
*X*XXX**X*XXX*X*X******X*XX*XX***X**X*XX*X*XXX**X*X*X**XXX*X*X*X*X*XXX**X*X*X**X*XX**X*X*X*X**X***X*X***X**X*****X**XX*X***X*XX*X***XX***X*XX*X****X*X*X**XX*XXXXXX*XXX**X**XX*X***X*X*XX*X*XX
*******X***X*X***X*XXX**X*****XX*X*X******X****X******X***X****X*X*****X***X**X**X**X**XX***X*X*XX****X*XX**X*XX**X**X**X*X**X*X*X*X***X*X****XXXX*X*X*X*X***X********XXX*X*XXXX*X***X****X**X
X*XXXXX**X****XX*X****X***XXX**X*X**XX*XXX**XX*X*XX*X***X***XX*X*XX*XXX**X**X*X*X*X***X***X***X**X*XXX***X*X****XX*X**X*X**X*****X**X*X**X*XXX****XX***X**X*XX*XXX*XX*****X**X***X*X**X*XX**XX
*******X*XXXX*X***XXX**X*X**X*X**X*X***X***X**X**X*X**X**XXX***X***X***X*X*X******XXX***XXX*XX*X*X****XXXX**XX*X***XX****X**XX*X**X***X*X*X****XX****XX*X*XX***X**X**X*XX*XX***XX*X*X**X**X**X
XXXX*X*X****X*X*XX***X**X**X****XX***XXX*XXXX*X*X**X*X**X***X*X*X*X**X*X*X**XXXXXX***XXX***X***X**X*X*****X**X***X***X*XX**X*XX**X**X*X****X*XX**XXXX***X***XX**X***X*X*X**X*X*X****XX***X*X*X
****X**XXXX*X*X*X**X**X**X***XXX***XX****X*X**X*XX*X**X*X*X**X**X***X**X*X*X*****X*X*X***X*X*XX*X**X*X*X*X*X**X*X*X*X*XX**X*****X**X*X**XX*X***X*X***X*X*XX***X***X*X***XX**X**X*XX**XXXX****X
*XX**X*****XX*X**XX**X**X**XXX***XXX**XXX***X*X**X**X**X***X***X**XX**X**X***XXX***X***XXX*X*X***X*X**X*****X*X***X*X****XX*XXXX**X***XXX***XX*X***X*****X*XX*X*XX****X***X***X****X*****X*X*X
*X*X**XXXX****X*X***X*X*X*X***XXX****X**X*X****X*XX**X***X*X*X**XX***X*XXX*XX***XXXX*XX****X*X*X***XX*X*XX*X**XX*X**X*X*XX**X****X**X****XX**X**XX**X*XX*X**X****X*XXXX*X**X*X**XX**XXXX*XX**X
****X*X***XXXX**X*XX*****X**X*X***XXX*X*X**XXX*X**X*XXXX*XX**XXX***XX*****X***X*****X***XXXX*X**XXX***X**XX**X***X*X***X***X*X*XX**X*X*X*XXX**X***XX**X**X*X*X*X**X****XX*X*X*X*X**X***X***X*X
X*X*X*X*X*X**XX***X**XX*X**X**X*XX**X*X**X*X*X**X*X**X**X***X****XX***XXX***XX*X*XX***XX*****XX*****X**X**X*XX*XX**X*XX**XX***XX**X***XX**X*X**XX****X**X****XX*X*X*XX*X**X***X**XXX*X**XX*X*X
***X****X**X****XXX*XXXX**X**X**X*X*****XX*X**X***X*X**X**XX**XXX**X*X***XXX****X**XXX**X*XX***X*XXX*X**X***X**X**XX****X***X****X**X***X*X**X**XXXXX**X**XX*****X**XX**X***X**X*X***X*X*X*X*X
*X**XXXX**X**X*X****XXX**X*X***X****XX*X***XX**XX*X***X*X****X***X***X*X*****XX**X****X*****X*X*X*****X**XXXX*XX*X**XX*X**XX*X*XX*X*XXX*X*XX***X****XX***X**X*X*X**X**X**XX**X*X*X*XX**X*X*X*X
*XX*X***X*X*XXX**XX**X**X***XX*X*XXX*X*X*XX**X*X*X**XX***XXXX**X**X*X**XX*XX***X**XXX**XX*X**X***XX*X**X*X****X****X**X*X**X*X****X***XX***X*X*X*XX***XXX**X***X**X*X**X**XX**X**X**X*X******X
*XX*X*X*X**X*X**X***X**XX*X***X**X***X*X***X*X*****XXX*X******X*X*X**X**X***XX*XX****X****XXX**X*****X***X*XXX**XX*XX***X*X***X*X*X*X****X***XXX***XX***XX**XX*X*XX**X**X***X*X*X**X**X*X*XXXX
XX**X*XX**X***X*X*XX**X***X*X**X***XXX**XX*X***XX*X*X***XX*XX*X*X**X**XXX*X**X**XXXX***X*X****XXX*XXX*XXX*XX***XXX***X*XX***X**X**XXX*X*X**XX***X*X*X*X**XX****X***X*X*XXXX*X*X***X*X*X**X***X
***XX****XX*X*X**X*X*X*X*XX*X*XXX*X****X*X*X*X**XX****X***X***X*X*X**X***X**X**X***XXXXX*X*XXX*X*X****X*X****XX*X*XX*X***XX**X**X****X***XX***X*****X**XX***X*X**X*X****X****X**XX**X**XX**X*X
*XXX**X*XX**X***X****X*****X***X***X*X*X*X*X**XX***X*X*X*XX*XX****X*X**X***X**X**X******X**X*X****X*XX***X*XX*X***X**X*X****X*XXXX*X*XXXX***XXXXXXX**X*X**XXX**XXX*X*X*X**XXX**X***X*X*X**XX*X
****X**X***X*X*X**XXX**XXX*XXX*X*X*X*X***X**X*X**XXX****X***XXX*XX**X*X*XX**XX**X*X*XXX*X*X***X*X*X**X*X****X***XXX*X**XXXXX****X**X******X*X*X****X*X***X***XX****X*X*X*X****XXXX***X**X*X**X
*XX**X***XX***X**XX***XX*X***XX**X*X*X*X*XX*X***X***XX*X**XX*X**X**X*****X*X***X***X****X**XX***X*XX****XXX*X*XX****X*X****X*XX*XX**XXX*XX****X*X*X***X*X**X**X*XXX**X*X*X*XX*XX***XX*X***X*XX
*X*X*XXX**X*X**X***X*X****XX****X*X**X*XX***XXX*X*X**X*X*X*****X**X**XXX**X**XX**X*X*XX*XX*X*XX*X***XXX*X***X****X*X****XXXX**X***XX***XX**X*XX*X*X*X**X**X**X**X***X**X*XXX*****XX***X*XXX**X
***X***X*X***X**XX*X*X*XX***XXXX***X*X**X*XX***X***X**X***X*X*X**XX*X***X***XX**XX*X***X***X****XXX***XX**XXX*X*X*X*XX*XX***X**XX*X**X***X**X***X*X**XXX*X**XX*X*X*XXXXX****XX*XX***X*X****X*X
X*X*XX**X**X*X*XX**X*X**X*XX***XXX*X**XX*****X***X*XX***XX***X**XX***X*X*XXXX**X***X*XX**X**X*XX****X**X*X*****XX*****X***X***X****X*X*X**XXX*XX***XX****XX*X**X***XX***X*X**XX***XXX*XXXXX**X
******X***X**X****X****X*****X******X****X*X**X*X****X*X***X***X***X**********X**X*X****XXX***X**X*XXX***X*X*X****X*X***X**X*X**XX***X**X*****X**X****X*X*****X**X****X****X****XX************
