*X***X****XX******X**X*****X***X***X****X***X****XXX****X*******X**X*******XX*****X*X******X*****X***X*X****X**X*XXX******XXXX*******X*X**X*X*XX****XXX******X*******X**X***X*****X******X*XXX
*X*X*X*XX****X*XX***X**XXX*X*X***X***XX*XXX***XX**X**X*X**XX*X*X**X**X*XX*X***X*X*****XXXXX**XXX***X*X***X*X**X***X**XXXX**XX**XXXXX*X***X*******XX**X**XXXX**X*XX*X*XX***X***X*X***XX*X*X**XX
*X*X***X*X*XX**X**XX**X**X*X**XXX*XXX*****XX*X*X*X**XX*X*XX***X**X**X****X**XX**XXXXX*X****X****X*X****XXX***X**X***X****X****X****X*XX*X**XX*X*X*XXX**X****XX***X*X**XX*XXX*X***XXX***X*XX**X
*X**XXXX**X***X*X****X**X***X*X***X**X*XX**X*X*****X*****X**X*X*XXX*XX*XX**XX*X*****XX**XX*XXX*X**X*XXX***X*X**X**XX**XX**XXXX*X*X*X**X**X***XX*X*****X*X*X****XX**XX**X**X*XXXXX***X*X****X*X
*X*X*****XX*XX**XX*XX**X**XX**X*X**X*X**XX***XXX*XX*XXXXX**X**X**X***X*X**X****X*XX****X*X***X**X**X****X**X**X*X**X*X*XXX***X***XX*X**X**X*X***X*XX*XX****X*XX*X*X**X**X****X****X**X**X*X**X
*X**X*X*X***X*X***X***XX*XX**XX*XX****X**XXXX***X*******X*X*X*XX***X*X**X*XX*X**X*XX*XX**XXX***XX*XX*XXX*X***X***X*X*******XX**X****X*X*X***X*X*X**X*X**XX*X****X*X*X**X**XX***X*X*X*XX**X**XX
***X**X*X*XX**X*X*X*X*X**X**X*****X*X*X*X***X*X***X*XXX**X**X***XXXX*XX*X**X*XX*X***X***X***XXX***X**X****XXX**X*X*X*X*XXX****X**X*X**X*X*XX***XX*X**X*X*X**X*XX**X**X*X*XX**XX*X**X***X*X*X*X
*XX**X**X*X**X**X***X**X***X**XX*XX**X**X*X***XXXX*X***X*XX**XX*X***X***XX*X**X*XX*X**X***X*X***X*X*XX*XX*X*X*XX***X**XX**XXXX**X**X*X*****X*XX***X*XX*X**X**X***X**X**XXX**X*****X*XX*X*X***X
*X**X**X**XX*X*X*XXX*X*XXXX**X**X***X**XX**XXX*******X*X***X****X*X***XX***XX*X*****XX**XXX*X*XX**X*X***X***X*X*XX**X***X*****XX**XX**X*X*XX****X*X****XX**XX**XXXX***X***X***XX*X**X**X*X*X*X
***X*XX**X***X*X*****X****XX**X***X**X*X**X***X*XXXXX**XXX*X*X*X***XX**X*XX****XXXX***XX****X**X*XX*X*XX**XX**X***XX*XX*X*X*X**X*X**X*X*X***X*XX*X*XXXX**X**X*X**X**XX**X**X*X*****X**X**X*X*X
X*X*****X**XX**XX*XX**XXX***X**X*X**X***X**XX***X***X*X**X**X***XX*XXX*X***XX*X****XX*X**XX*X*X**X****X**X***X**X****X**X*X**X*X**X***X**XXX**X****X****X*X*X*XX*X*X***X*X*XX**X*XXX*X**X***XX
*X**XXXX*X****X***X*X*X**XX**X*X**XX**X**X****XX**X*X**X**X**XX**X**XXX*XX****XX*X**X**X***XX**XX**XXX*XX**XX*X**XXX**X*X*X*X**X*XX*XX**X***X**X*X*X*XX*****X**X*X***XX**X***XX*X****X*X**X**X
***X***X*X*XXXX*X****X**X**X****X***X**X**XX*X*X*XX**X***X*X***X**X**X****XXXX***XX**X**XX***X****X*******X****X****X*X**XX**X*X****X**X**X**X*X*X**X**X*XX*XX*X*XXX*X*X**XX****X*X*X**X*X*X*X
*X**XX***X*X***X*XXX***X*X**XXXX**X*XX**X*X*X**X*X*X**XX*X***X**X*XX*X*XX****X*X***XXXX*X*X*X**X*X**XXXXX*X*XX*X*XX**XXX***X*X**XX*X*XX*X*X*X****XX*XX*X**X**X*X****X***X***XXX*X**X**X****X*X
**X*X*X*XX***X*****X*X*****X****X*X***X**X****XX*X**X*****XXXX*X*****X*X*X*X*X**XX***X**X*X**XXX*X*X*****XX*X**X***X**X*XX*X**X*X*X*******X*X*XXX*X*****X*X*X***X*X***X*X*X***X***X**X*XXXX**X
*X**X***X*XXX*XXXX***XXX*X*X*XX**X*X*X*X***X*X***X*X*XXX*X*****X*X*X*X***X*X**X*X*XX***X****X***XX**X*XX*X**X*X*XX**X****X*XX*XX***XX*XX*X**XX**X**XXXX***X*X*XXX**XX**X**XX*X*X*X**X*****X*XX
*X*X**X*****X*X***X*X****XXX***X*X******XXX**X*XX*******X**XXX*X*X*XX**X*X*X*X**X***XXX**X*X**X***X***X**X*XX*X*X**X*XXX*X**X****X**X***X*X***X**X*****XX**XX****X*XX*X**X*X****X**X**XXX*X*XX
*X**X**XX*X***X*X***XXXXX****XXX***XXXXX****X**XX*XXX*X**X****X***X***X*X**X*X*X*XX***XX*X*X*XXXX*X*XX*X***X**X*X*X****X**X**XXXXXX***X*X*X*X**X***X*XX*XX***XXX*X***X**XX**XXX**X**X*X***X**X
*XX**X***X**XX**X*XX****X*XXX***XX*X*****XXX**X***X**X*X**XXX*XX*X**XX**X*X**X*X****X****X*X**X***X*X**XX*X**X**X*X*X*X*X**X*****X**X*X*X**X*X**X*X**X***XXX*X*X*XXX***X***X***X**X*X**XX*XX*X
**X*X*XX**XX***X*X*X*XX*X*****X*X**X*X*X*X***X*X*XXX****X*X*X***X**XX**X***XXX*XX*XX**XX*X**X**X*XX**X***X*X*X*XX*X*X***X*X*XXXX**XXX*X**X****X**XXX***X***X***X****X*XX*X*X*XXXX***XX*X***X*X
X*X*****X*X**X*X***X**X*XXXXX*X*X*X**XXX*X*XX****XX*X*X*X****XX***X***X**X*X******X*XX**X**X**X**X*X*X*X***X*X****X*XX*X*******XX****X**X**X*X*X**XXXXX**X**X*X*X*X*X*X**X*X***X*XXX*X*X*X***X
***X*XX*X***X**X*X*X*X*******X**X*X*X***X**X**XXX***X*X**XXX*X**XX*X*X*XX****XXX*X*****XX*X**X*X*X***XX**X*X**X*XX***X**XXX*XX***XXX*X*XX*X**X**X**X***XXXX*X****XX*X*X*X**X*X*****X****X*X*XX
*X**X****XXX**XXXX*X**XX*X*X**X*XX**X*X***XX*X****X*X**XX*****XX*X***X***X*XX***X**XX*XX***X*X***X*XX***X**XX*X*X**X**X***X***XX*X***X*X***X***X**X**X***X****X*X***X***XX**XX*X*X***XX*X****X
**X**XXX****X**X****X***X*X**XX****X**XXX*X**X*X*XX**X**X*X*X*****X*XX*X**X***X*X*X*X****X*X*X*X*X**XXX**X**X*X**X*X*X*XXX**X*XX**XX***X*X*XXX**X***X*XX*XX*X**X**XX*XXX**X*X***XXXXXX**XX*X*X
X**XX***X*X*XX*X*XX**XX***X*XX**XX**X****X**X**X***X***X***X*XX*X***X**XX***XX**X*X**XXX**XX*X**X*X*****X*X*X**X**XX******X*X***X***X*X***X****X*XXX**XX***X**XX*X*****XX*X*X*X**X****X***X**X
*X**X*X*X*X**X***X**XX**X*X***X***X**XX*X**X*XX**X**X*X**XX****XXX*X**X**XXX**X*X***X***XX***X*X**XXXX*X**X**X**X*X**XXXX**X*XX**XXX*XX*X*X*XX*X****X***XX**XX***XXX*X****X**XXXXX*XX**XX**X*X
***X**X*X**X**XX**XX***X*X*XX*XXX**XX***X*X*****X**X*X**XX**XX**X**X*X*X*X**X***X*XX**X*X**XX**X*X***XX*X**X*X*X***XX****X***X*X*********X***XX**X*X*X*X***X***XX*****XXXXXX*XX****X*X***X*X*X
*X*X*X***XX**X***X***XX*****X***XX**X*XXX**X*XX*X*XX***X***X**X**XX**X*X***XX*XX*X***X****X***X**X*X******X**X*X*X*X**XX*X*X*X**X*XXXXXX*X*X**X*XX***X*X*XX**XX*X*X*XX****X*****X*X**XXX*X*XXX
*X*X**XX****XX*XXX*XX***XXX**XX***XXX****X*XXX**X****XX**XX**X*X**X*X***X*XX**X****XX*XX*X*XX**X****XX*XX*X*X**X*X*X*X*X***X*XX**X******X***X*X***XX***X*X*X*X*****X***XX**X*XXX*X*X*****X***X
*XX*X***X*X*X**X***X**X*X***X**XX****XXX*X****X**XXXX***XX*X****X*X*X*X***X**X**XXXX***XX****X**X*X**X**X*X**X**X****X**XXXX***X***XXXX*X*XX**XXX*X*X*X**X****X*XX***XXX*X**X**X***X*XXXX**X*X
****X*X**X*X**X**XX*X**X**XX*X***XXX***X*X*XX**X*X**X*XX***XX*XX**X*X**XX*X*X**X*****X****XX**X**X*X**X*XXX*XXX**XXXX**X****XX*X*X*****X****X***X*X*X*X*X**XX*X***X*X*****X**X**XX***X****XX*X
X*X**X**X**X*X**X*****X**XXX*X*X***X*XXX*XXX**X****X**X**XX******X**X*X*X*X**X***X*XX*XX*X**X**X*X**X*X******X*X*X****X**X*X***X**X*XX**X*X*XX*XX***X*X**XXXX**XX**X*X*X*X*X**X**X*X**XXXXX**X
*X**X**X**X**X*X**XX*X*X**X***X**X*X********X*X*XXX**X**X*X*X*X*X**XX*X****X**XX**XX****X**XX*XX***X***X*XX*X****X*XX***XX**XX**X*X***X**XX***X***X*X**X***X**X*X*X****X*X**X**X**X*X*X*****XX
***X*X**X***X***X*X**X**X***X***X***X*X*X*X***X*X***X*X*X*X**X*X**X***X*XXXXX***XX***XX*XX*X**X*X*X**XX*XX**X*XXX**X*XX*X*X***X*X**XXX*X***X*XX*XX*X**X*XX***X****X*X*XX**X**X**X*****X*XXX**X
*XX***X**XXX*XX**XX*X*X**X*X**XX*XX**X*X***XXXXX**XX*******X*X***X*X*XXX***XXXX****XXX***X***X**X*X*XX****XXX*X***XX***X***XX*X*XXX****X*X*X*X***X**X****XXXX**X*X***X**X***XXX**X*XXX**X**X*X
***X*X*X******XX*X****X*X*X*XX*****XX***XXX***X**X*X*XXXXX*X*XX*X****XX**X**X*XXXXX****X**X*X*X***XX***XX*X***X*XXX**X***X**X*******XX*XX**X*X*X**X**X*XX****XX***XX*X*X*XX*XX*X*******X*X*X*X
*X******X*X*X******XX*X********X*X****X*****X***X********X******X*XX****XXX*********X*XXX***X***X****XX*****XX******X**X**X**X*X*X*X******X*****X***X*****XX****X****X**********X*X*X*X*******
