*XX***X******X*********X*****X********X****X*XX**X***X******XXX*****X****X****X****X*******XX*******X*X***X*****X***X******X****X***X**X******X*X******X*********XXXX******XX*X**X******X*X**X
*X**X**XX*XX***X*XXXXX**XX*X*X*X*XX*X**X*X******X**XX**X*XX**X**X*X*X*XX***XX**X*X***X*X*X****XXX*X*X***X**X*XX***XXX*X*XX***XX***X***X**X*X*X****XX*X*X*XX*XXXX**XX**XX*X******X**XX*X*X***XX
***X**X***X*XXX**X****X*X**X*X*X**X**XX**XXXXX*X**X***X**XXX**XX**X*X***X*X*XX*X*XXXX*X**X*XXX***XX*X*X**X*****XXX****X***XXX*XX*XXX*X**XXXX***XXX**X**X***X***XX****X****XX*XX*XXX*X*X**X*X*X
*XXXX*X*XX******XXX*X*X***XX*X**X*XX**X*X****X***X**XX*X**XXX***X*X**X*X**X****X******X*X*X****XX***X*X*X*XX*X*X***XXX*XX***X***X*XX**X**X***XX****X**X*XX*X*X***XXX**XX*X*XX*********X*X****X
*X*X**X**X*X*XXX*X***X*XXX***XX*X***XX**X*XX*X*XXX*X****X**X*XX*X**X*X**X*X*XXXXXXX*XX**X***X*X***X*X**X****X**X*XX**X*X*XX*X*X*****X*X*X**X*X**X*X**X**X**X**XXX***X**X*X****XX*XXXXX**XX*X*X
*X***XX*X**XX******X*X****X*X**X*XX*X**X***X*X*X***X*XX**X*X*X****XX*X*X**X*X**X*****X*X*X*X**X*XX*X**X**XX*XX*X***X******X*X**XXX*X**XX**X*X**X****X*X*X*X*X***X*X**X*X**XX*XXXX*****X***X**X
**XX*X***X***XXXXX*X***X*XX**X******X*XXX*X**X***XX***X*X**X***XXXX**X**X*X**X***X*XXX****XX*X**X***X**X**X**X***XX*X*X*X*X**X*X*X**X***X*X***X*XXXX******X***X*X*X*X***X*X**XXX**X*X*X*X**X*X
X*X***X*X*XX******X**X*X*X**X*X*XXX*X**X**X*X*XXX*X*X*X*XX**XX*X***X**X*X**X*X*X*XX***XXX*X**X*X**X*XXX**X*X**X*X****XX*X*X*X*****X**XX****X*X*****X*XX*XX**XX**X*X*XX*X**X*X*X**X*X***X*X*X*X
X*X*XX****X*XXX*X**XX*X**X*X****X****X**XX****X***X**X***XX***X**X**X**X**X***X***X*X*****X*XX***XX***X*X**X*X***X*X****X*X*X*X*X**X***XX*X**X*X*X*X***X**XX***X**X***X**X****X*X**X*XX**X*X*X
***XX**X*X*****X*X****X*XX***XXX*X*X**X***X*XXX*X**X**XX***XX***X*X*XX***XX*XX**X*X**XXXXXX***XXX**XX*X*XX***XX*X***X*X**XX**X**XX**XX**XX**XX*X*X**XX*X*X***XX**X*XX**X**XX*X****X**X**XX*X*X
*XX***XXX**XXX****XXX*X***XXX**X****XX*XX*X*****X*X*X**XXX***XXX**X***X*X*****X**X**X******XX*X***X*X*X**X*XX***X*X**X*X***X*X*X**X**XX****X****X*X**X*****X*XX*X**X*X**X***XX*X*X**X**X***X*X
*X**XX*X**X***X*X***X**X*X***X*X*X*X***X***X*X*X**X**X****XX*****X*XX*X**XXXX**XXX*X**XX*X*X****X*X***XX*X*X**X**X*X****X*X**X**X**X***X*XX**XX***X*X*XX*X**X***X*X**X*X**XX****X**X*X***XX**X
*X*XX****X*X*X***XXXXX*X*X*X***X**X**X***XX**XX*X***X**X*X**XX*X***X**X*X****X*X***X*X***X**XX*X**X*XX***X**XX*X*X***XX**X**X*X*X*X*XX**X***X*X*X*X***X***XXX*XXX***X**XX****XXXX*XX***XX***XX
*X***X*X***X***XX***X**X**XXX*X**X**X*X*XX**X***XX*X**X*X**X*X*X*XX**X**X*XX*X***XX**X*XXX*X***X*X**X*X*X*X*X**X*X*X*X**X**X**X***X***X**XXX**X**X**XX**XX****X***X*X*X***XXX*****X**XX*XXX**X
*X*X*X**X*X**XX***X**X**X**XX*X*X*X****X***XX*X**X**X*****XX*X*X**X*X**X**X*XXX*X*X*X**X*****XXX*X*X****X*X*X*X***X**X*X**X*X***XX**X**X****X***X**X***X*X*XXX**XX**X**XX****X*XXX**X*******XX
**XX**X*X**X*X**X*XX*X*X*X****X****XXX*XX*X***XX**X*XXXXX****X*XX*X**XX**X***X*XX***XX*X*XXX*X***X**XX*X**X*X***X**X*X*X*X**XXXX***XX*X*XXX**XXX**X*X*X****X***X**XX*X***XX*X**X*X*X**XXX*X*XX
X****X*XXX*X*X*X***X*X*X**X*X**XX*X**X***X**XX**X*X******XXX*X***X*X**X*X*X*X****XX**X**X***X**X*X*X***XX***X*X**X****XX**X****X*XX***X*X**X****X***X*X*XXX**X**X****XXX*X*X**X**X*X*X****X**X
XX*XX***XX**XX**X*X**X**X***XXX*X***X*XX*X*XX**XX**X*XXX*****X*X****X*X*******XX*X*X**X***X*X*X*XX***XX***X**X*XX*XX*X***X**XX*X*X**XX****X*XXX**XX***X*X**X**X*X*XX*****X***X**X**X**X*XX*X*X
X**X**X***X***X**X**XX*XX*X******XX*X**X***X**X**X**X***XX*XX*X**X*X***X*XXXXXXX*X*X*X*X*X***X****XX*X**XX*XX******XX**XX**X***X*X*X***XXXX*X**X***X*X**X*X*X**XX*X*XXXXX**XX*X**X**X*X*****XX
**X**X**X***X*XX**X*X**X**XXXX*XX*****XXXXX**X*X**X*X*X*X*****X*X**X*X**X*****X**X******X**XX**X*X**X**XXX****XX*X***X****XX*X***X**X*X*******X*XX**XXX*X*****X***X*****XX*X***X***XXX**X*X**X
*XXX*X*XXX*XX**XX*X***X*XX***X**X*XXXX*X****XX***XX*X*X**XX*X*X*X*X***X**XX*X*X*XX*XX*X**X*X**XX***X**X*X**X*X**X**X**X*X*X***X*X*X*X***X*XX*X***XX**X**XX*XXX**XX**X*XX***X*X*X*XX*X**X*X*X*X
*XXX*X*XX*X***X***X*XX*****X**X*X*X******XXXX**X*X**X**X***X*X**XX*X*X*X****X*X*X***X**XX**X*X**X*XX*X****XX**X**X**X**X***XXX*XX****XX*X***X**X**XX*X*X*X***X*X***X*****X**XX*X**X*X*X****X*X
**X**XX****X*X**X**X***X*XX**XX***X*XXXX******X***X**X**XX*X***X***X****XX*X**X*XX*X**X***XX***X**X**XX*XXX**X*X***X*X**X*X******X*X*X**XXX***X**X***X*X***X***X*X**XXX*X*X*X***X*X****X*X***X
X*X*X***XX**X**XX*X**X**X***X***XX**X***X*XX*X*XX**X**X*X****X*X*X*X*XX*X**XXXX***X**X**X*X*XX**X***X***X***XX***XX***X**X**XX*X*X*X**X***XX*XX*X**XX***X*XXXXXXX*X****X****X*X*X**XXX*X**X*XX
**X*X*XX***X**X***X*X*XX**XX*X*X*X*X**X**XX**X***X*XX*X*X*X*X*XX*X**X*X*X*X****XX*X*X*X*X****XX**XXX*XX*X*XX***XX***X**X**X***X**X*XX*X*X**X***X*X*X**XX***X***X***XX*XX*X*X**X**X***XXXX*X**X
*X**X*X*XX***X*X*X**X**X*X***X*X*****XXXX***X**X****X*X**X*X******X***X*X*X*XX****X***X**XXX***X***X****X***XXX*X*XX**X**X*XX**X**X***X**XX*XX*X***X*X***XX**X***X***X***XX*X**X**XX***X**XX*X
**X*X*X****XX***XXX**X*X**XX****X*X*X*X***X*X*X**XX*X*XX*X*X*XXXXXXX*X**XXX***XX*X*XX**X***XXXX*XX*X*X*X*XX*****X*X**X*X*****X*XX***XX*X*****X*X*XX**X*X*X**XXXXXXXX***XX****X**X***XX*X*X*X*X
X***X**XXX**X*X**X*X****X**X*XXXX**X****XX*X***X*X*X***X*****X****X***X****XX*X*X**X*X*XXX*********X*XXX***XXX*X***X*X**XXXX*X**X*XX****XX*X*X*X*XX*X*X**X*X*X***X**XXX***X*X*X*XXX*X**X*X***X
*XX**X****XX**XX****XXX**X*X*X***X*X*X*X*****X**X***XX*X*XXXXX*XX***X**XX*X*X*X**X***X***XX*X*X*XXX*X****X***X***XX**XX****X**X**X***X*X*XX**X*X****X**X***X***X***X****X**X**X****X**X**XXX*X
***X**X*X*XX*X**X*X***X*X**X*X*X*X*X**X*X*X*XXXXX*X*****X******XX*X**X*X**X*X**X***X*XXX***X*X*X******X*X*XX**X*X***X**X*XX**X**X**XX**X****XX**XXXX*X**XXX**XX*XX**X*XXXX***XX*X*XX*X**X***XX
*X***X**X******X**X*X*X**X**X**X***X*X***X**XX****XXXXX*X*X*XXX****X*XX**X****XX*XXX****X*X******XX*XXX*X***X**XX*XX*X*X*X**X**X**X***XXX*XX**X****X**X****X*X****X*X*X*X**X*X**X*****X***X**X
**XXX*XX*X*XXX*X*X**XX**X*X**X**XXXX***X*X*X***XXX*****X***X***X*X**X***X**XXX***X**XXX*X*X*XX*X*XXX***X**X***X***X******X*XXX***XX*XX*X**X**X*XXX***X**X*XX**X*X*X*****X*X*X**XXXXX*X*XX*X*XX
X***X*****X***X***XX***X****X**X****XXX**X*X*XX**X*X*X***XX**XXX**XX**XX**X***X*X**X****X*X***X***X**X**X**X*X**XX**X*X*X**XX**XX***XX*X*X**X**X*X*X**XX**X**X**X**XX*X*X***X*X*X***X****X***X
*XX**X*XX*X*X*X*XX***XX**X*X**X**X*X***X**X***XX****X**X*X**XX***X***X***X**X*X***X**X*X***XX**XXX**XXX*X*X**X*X**X**X**X*X***XX**XX***X*X*XX*X**X**X****X**X*X*X*X**X*X**XX**X***X***XX**XX*X
****X**X****X*X****XX**X**X**X**X***XX**X*X*X***X*X**XXX*X*XX**X*X*XX**XX**XX*XXX**X**X**X***X*****X*X**XX**X**XX**X*X*X***X*X***X**X*XX********XXX**XXXXXX*X***X*X*X**X*X***X**XX*XXX**X*XX*X
*XXX**X*XXXX***XXXX***X*X*X*X**X*X*X***XX**X*XX*XX*XX****X*X**XX*X*X**X**X***X***X*XX***X*X*X*XXXXX****X***X**X*X*XX*X***X**X**XX*X*****XXXXXXX*XX*X*****X***X*XX*X***XX**X*XX*X*X***X*X*****X
*****X*******X******X***X*****X******X***X************X*X****X***X***XXX***X***X*****X*X************X*X**X***X********X*XXX***X*****X*X*************X*XX***X***X****X***X******X***X*****X*XXX
