*X*X*****X*X*******X****X***X*XX*X********X***X****X***X******XX***X******X**X****X**X****X***X******X****X*XXXX**X*X**X***X***X*******X**X*X***X*XXXX****XX***X****X*******XX*****X*********X
*X***XXX***X*XXXX*XX*XX***XX*****X*X*X*X*X**X*X*XX***X***XX*X****X*X*XX*X**X**XXX***XX*X*X**X***X*XXXX*X*X***XX**X****X**X**X*X**XXXX*X**X**X*X****XX**X*X***X***XXX**X*XXX***XX*X**X*XXXX*X*X
*X*X*X**X*X**X**X*X**X**XX***X*XX***X**X***X**X*X**X**X*X**X*X*XX**XX****X*XX*****XX***X***X**XX*X*****X***X****X**X*X**X*X*****X***X***X**X***XXX****XX*X*XXXXX*****X**X***X****XX***X***X**X
*X**X**X**X*X*X*X**X*X*XX**XXX****X**X**X*XXX**X**X*XX*XXX***XX**X***X*X*X***X*XX*X**XX*X*X*X****X*X*XX*XXX*XX*X**X**X*X**XXXXX*X*X***X***X**X****X*XX***X*X*X**X*XXXXX*X*X**XXXX***X*X*X***XX
*XX***XXX***X****X*X*X****X***XX*X*XX*X**X*X*X*X*XX*****X**X***X**XX*XXX*X*XX***X*X*X****X**X*XX****X*X******X*X*XXX*X**X******X***X*X**X**X**X*XX***XXXX**X***X*X***X**X*XXX***X*XX*X**X*XX*X
***XX**X*XXX**XX*X***XXXXX**X***X******X*X***X***X**X*X**X**XX**X**X*****X***XX**XX*X*XX**X*****X*X*X***X*X*X**X**X**X*X**X*X*X**X*XXX*XXXX*X*XX***XX***X*X*X*X****X**X**X****X**X****X**X***X
*X**XX***X**X**X**XXX******XXXX**XXX*X*X*XX*X**XX**X**X*XXX*XXX*X*X*XX*XX*XX*XXX****X**XX**XXXX*X*X*X*XXX*X*X*XX*X**X**X*X**X*X*XXX***X*X******X*XX***X*X*X*****X*XXX*X*X**XXX*X***XX*X*X**X*X
**X**XXX**X**X*XXX***X*X*XX*X**X*X***X*X**X***X***XX*X***XX**X*******XX****X**X*XXXXXX***X****X**X**XXX***X*X*X**X*X**X*X**X*XX**X**X*****XXXX*X*X**XXX***XXXXX*X**X*XX***X*****X*X*X**XX*X**X
X*XX****X*XX*******X****X****X*X***XXX**X*X*XX**XXX**X*X***X*X*XXXXX****X*XXX*******X*XX**XXX**XX**X****XX**X*X*X**X*X****X****X***X*X*XXX****X**X*XX**XXX*****X*X*****XXX**X*X**X***X*X**XX*X
****XXX*X***XXXXX*XXXXXX**XX*X***XXX**X*X**X***X***X**XXXX*X**X*****XX*X***XXXXXX*X*****X*X**X*X**XXX*XX*X*X**X**X***X*X*X**XX**X*X***XX***XX**X*X****X***X*XX***XX*XX*X***XXX**X**X*X***X***X
*XX***X*X*X*****X**X****X**X**XXX***X****X***XX**X**X**X*X**X***X*X***X**X**X****X*X*X*X**X*X**X*X*X***X***X*X*X**X*X***X**X*X*X**X*X****X*X*X*X**XXX**XX***X*XX***X***X*XX*X**X**X***X*X**X*X
*X*X*XX**X*XXXX***X**XX**X**X***X*X**XX*X**XX***X**XXX***XX**XX**XXXX*XX**XX**XXX***X**X*X****X**X***X*X*XXX****X**X*XX**X***X**XX**XXXXXX****X**X***X*X**XXX***XX*X*XX**X****X**X**X**XX*XX*X
X**X***X***X***XX*X*X*XX***X*XX***XX***X**XX**XX**X*XXXX***X***X**X*X***X****XX***X***X***X*XX**X**XX**X*X**X*X**X*X**XX*XXX**X****X******X*X*X*XX*X***X*X****X**X***X**XXX*XX*X*XX**X*X**X**X
**X**XX*XX***XXX**X*X***X*XX***XXX**XX*X*XX**X***X***X***X**XX**X****XX**X*XX***XX*XXX**XX**X*X**XX***XX*XX*X**X*X*XX**X*****XXXXXX**XXXX***X*X*X***XXX**X*XX*XXX*XX**X**X*****X***X*X*X*XX*XX
*XX*X****XXX*****X**X*X**X***X*****X*X**XX**X**X*X*X**XX*XX*X*X*X*X*X**X*X**X*XX***X***X***X***X*XX*XX*******X*X*X**XX*X*X*XX*X***X*X****X*X**X**XX*X**X*X**XX*****XX*XX*XXXXX*X*X**X**X*X***X
*X****XX****XXXX*X*XX**X*X*X**XX*X*X**X****XX*X*X***X*****X***X**X****XX**X*X**X*XX**X*X*XXX*X*X****X*XX*X*XX**X**X**X****X*****XX**X*XX**X*X**X**X*XX****X**X*X*X**X**X*****X**X*X**X*X**XX*X
*X*X*X**XXX*X***X*****XX*X*X*XX**X***X*X*XX***X*X*XX*XXXXX**XX*X**X*X*X*X*X**X*X****X*X*****X***XXX*X*****X***X**XXX*X*XX***XX*XX**X***X*X***X**X*X***X*X**X*X*XX*X**X**X*XX**X*****X**XX**X*X
**X***X****X**X*XXXX*X***X**X***X**XX***X***XXX***X**X****X*****X*XX****X**X*X*X*X*X****XXX*XXX*X**X**XXX*X*XX**X*XX**X**X*XXXX***X**X*X***X*XX*X***X**XXX*X*******X*XX**X**X**XX*XX**X***X**X
X*X*XXX*XX**X*X*****XX*X*X*X**XXX*X*X*X*X*XX***X*X**X**XX**XXX*XX***XXX**X**XX**X**XXX*X**X***X***X**X***X**XXX*X***X***X***XXX*XX**X*X**XXX**X**XXX*X**X***XXXX*X*X***X*XX**X***X**X*X*X*X*XX
**X*X***XX*X***XXXX****XX**X*XX*****X*X*X*X**X*X***X**X*XX***X***XX*X*X*X*X***X*X*X***X**X*XX*X*X***XX*X*X*X*X**XX*XXX*X**X**X**XX*X***XX***X**X***X*XX***XX***XX**XX*XX***X**XX**X***X**X***X
*X**X*XX****X*X****XXXX***XX***X*X*X**X*X*X*X**X*X*X*X****XX*X*X**X*X*X*X**XX*X*X***X**X******XXX*XX***X*X*X***X*X**X***X*XX*X*X***X*X****X**X**XX*X***X*X*X*X***X**X***XX**X***X**X*X*X**X*XX
***X**XXX*XX**X*XXXX****XX**XX*X**XX*X**X*X**X*X**X**X*X*XX**X**XX**X*X**X*X**X**X*X**X*XX*X*X***X***XX****XXX*****X**XX****X**X*XXX*X*X*X*X***XXX**X*X*X****XXX**X*XXX*X**X*X*X*X*X****X*X**X
*XX**X*X*****X**X****XXX*X*X***X*X***X*X**XX*X**XXX*X*X**X**X*XX***X**X*XX*X*X*X*X*X*X****X**X*X**XX*X**X*X***XXXXX**XX**X*X**X*X****X**X***XX*XX*X***X***XXX***X*X***X**X***X***X**XX*X***XXX
*X**XX***X*XX*X***XXXX*****X*X**X**XXX***X****X*X***X***X**X*****X*X*X*****X***X**X**X*XX*X*X***X**X**X**X**X*******X***X**X*X****XXX**X**X**X****X*X*X*XX****XXX**XX**X*XXX**X*X*X**X*X*X***X
*XX***XXX*X***X*X*****X*XX*X*XXX**X***XXXXXX*X**X*XX**X*X*X*X*XXX*X***XXXX**X*XXX*X*X***X*X**XX**X**X*X*XX*X*X*X*XXX*X*X**X***XXX***XXX**X*X**X*X*X**X**X*X*X****X***X*X****X*X***X*X**X**XX*X
***XX*******X**X*X*XX*X***XX*****X**X****X***X*X***XX*X*X*****X*****XX****X*X**X**X*X*X*X**X*X**X*X*X**X***X**X*X*****XX*X**X***X*X****X*X**X**X*X**X**X***XX*X*X*XX**XXX*XXX**X*X**X*XX*X***X
*X***XXX*XXX*X*X**X***XXX***X*X*X*XX**XX***XX**XXX***XX**X*XXX**XXX****XX*X**X***X*****X*X*X***X**X**X*X*XXXX****X*XX***X*X**XX**X**XX****X**X***X*X**X**X*X**X****XX**X*****X*X*X*X****X**X*X
*X*XX***X****XX**XX*XX***XX**X*X*****X**XXX**X***XXX***X**X****X***XX*X****X**XXX**X*X***X*XXXX*X**X***X***X**XX*X***XX*X**X***X**X**XXXX***X*X*XX**X***X**XXX**XX**X*X**XXX*****X**XXX*XX*X*X
X****XX*X*XX****XX**X**X***X****XX*XX**X***X*XXX****XX*X*X**XXX**X***X*X*X**X*X**X*XXX*X*X****X*XX*X*X**XX**X**X**XX**X**X*XX*X*X**XX***X*X*X*X*X**X*X*XX*X****X***X***XX***XX*X*XX***X**X*X*X
**XX*XX*X*XXXXX****X*X**X*X*X*X**X***X*X*XX*****X*X**X*X***X***XXX*X***X*XXXX**X**X***X***XXX*X****X**X*X**X**X*X*X**X**X*****X**X**X*X**XX*X*X***XX**X***XX*XX**XX**XX***X***XX***XX**X***X*X
XX*X****X**X***XX*X**X*XX*X****X*X*X*X****X*XX*X*X**X**X*X**XX*****X*X*X*****X**X***X*XXX***X**X*X***X*X**XX*X**X**X**X*XXXXX***XX*X***X*X*****XXXX**X**XX***X**X***X***XX*XX***XX*X*X*XX*X**X
****XXX**X*X*X***X**X**X**X*XX*X**X***X*XX**XX*****X**X*X*X**XX*XXXX**X*XX*X**X**X*X****X*X**X*X**XXX****X***XX**X*X*X*******XXXX**X*XX***XX*X*X****X*X*X**X**XX**XXX*XX*X**X*X**X*X*X***XX*XX
*XX***XXX**XX**X*XX***X**X*X*X**X*XX*X*****X**XXX*XXX*X****X**X*X***X*X***X**X*X*X*X*XX**X*XXX**XXX***XXX**XX***X****X*XXX*X******XX***XX*X*X****XX*X****X*XXX***X****X***X**X*X*X***XXX*X***X
**XXX*****X***X***XX*X**X*****X*X**X**X*XXXX*X***X*XX*X*XX**X*X**XX*X**X*X**X**X*X**X*XX*X****X*****X*X***X***X***XX**X***X*XXX*XXX**X*X**X***XX**X**XXX*X*****XX**X*XX*X**X***X**X*X****X*X*X
X***X*XXXX**X**XX****XX*X*XXX***XX**X*X*X******X*X****X*XXXXX*XX*X**XX*X**X***X***X*X*****X*X**X*X*X****XXX*X*XXXX*X*X**X*X****X***X*X*X*X**XXX*XX**X****X*X*XX***X*X***XX*X*X**X**X**XXX**X*X
**X**XX***XX*X*X*XXXX***X*X*XXXX*X*XX*X***XXXXX***X*XX***X*******X*X****X**XX**X*X**X*XXXX***X**X*X*XXXX***X*X******X**X****XX***X**X**X**XX******XXX*XXX*X****XX*X***XX*X*X*XX*X*XX*X***XX**X
*XXX****X******X******X***X************X*X******X***X**X***X*XX*X****XX***XXXX*****X*******X**X**********X*****XX*X***X**X*X***X**X***XXX****XX*X*****X*****XX****X*X****X****X******X*X******
