***X*XXX*******X***X*********X********XX***X***X***X***XX***********X***X******X****X***X***X****X*******X*X****X***X****X*******X*X**X**X****XX*****XXXX**X***X***X***X*X*X**X***X****X*****X
XX****X**X*X*X***XX**X*X*X*X**XX*XX*XX***X***X***X*X*XX***XXXXXXX*X*XXX***XX*X**XX*X**X***X***X*X**XXX*X***X*XX***X***XX*X*X*XXX****X**X*X*XX****XXX**XX**X**X***X**X*X******X**X**XX*X**XXX*X
*X*XX***X***X*X*XX**XXX**X**X*XX**XX***X**XXXXX*X**X*X**X*X*****X*X****X*X**X*X*X***X*X*XX*X*XX*X*X***X**XXX*X*XXX*X*X****XX*X**XXX**X*******X*X****X****X**X*X*X**X****X*XX*X*XXX**X***X****X
*X*XXXXX*XX*X*X****X*X**X**X*****X***X**XX***X*X**X**X*X*X**XXX*X**X*X*X**X***X**X*XX**X***X***X**X*X***X****X*****X**X*X*X**X*X**X*XX*XXXXX*XX*XX*X*X*XX**X**X*X*X**X*XXX***X**X*X***X*XX*XXX
****X*****X*X**XX*X***XX**XXXXXX*X*X**XX***X*X*X*X**X**X*X*X**X**X**X**XX*X*X**X*X*X*X**X*X*XX*X*X**X*X**X*XXXX*XX**X*XXX***X****X****XX****X****X***X**X*X**X**X*X*X***X**XX*X****XXXX**X***X
*X*X**XXX*X**X***X**X****X*X***XXX**XX***XXX*X***XX*X*X**X**X*XX***X**X***X**X*X*****XX*X***X**X**X*X**X*X***X***X*XX****XXXXX*X***XX*X**XX*X*XX**XX**X*****X**X**XX**XX**X****XX*XX***X**XX*X
X**X*X**X**X*XX*X**XXX*X***X*X****X****X*X****X*X*X*X***XXX*X****XX*X**X*X**X**XXX*XX***X*X**X***X**XXXX**XX*X*X*X*X*XXX****X**X*X*X**X*XX**X*X*X***X**X*XX*XX*X*X***X***X*X*X**XX***X**X*X**X
**XX*X*X**XX****XX**X***X*X**XXXX*X*X*XXX**XXX**X***X*X*XX**X*XXX****X*X*X*X*X***XX***XX***X**XXX**X****X*X**X*X*X******XXX**X**X*X**X**X**XX*X*XXX*XXX**X*X***X**XX*X*XX*****X****XXXX**X**XX
XX***X*XX***XXX***X**XXXX*X*X******X**XX**X****X**X*X**X***X*X***X*X***X*X*X**XX**X*XXX**X**X*X***X**XX*X**X*X**X*X*XXX*X**X*XXX***X***X**X***X********XX****XX**X***X**X*X*XX*XX*X**X*X*XX**X
***XX****XX*X***X*X*X****X**XXXX*X**XX***XX*XXX**X**XX*X*XX****X*XXXX*X******X**X*X****X**X*X*X*X**X**X**XXX*X*X****X*X**X*X***X*X**XXXX*X*X*XXXXX*XXX****XXX***X**XX*X*X**X*****X*X***X***X*X
*XX*X*XX*****XXXXX**X*XX*X*X****X*X*X**XX***X***X**X*X*X**X*X*XX***X***XX*XX*XX*X**X*X**X**X**X**X**X**X*X***XXX*X*X**X*X***XX***XX*X****X****X***X***XX*X***X*X**X***X**X*X*XXX*X***XXX*X*X*X
*X**X*X*XXXXX***X**X**X****X*XX***X*X*X*X*XX**XX**X**X*X*X***X**XX*XXX***X*******X****X*XXXX*XXX**X*X*XX***XX****XX**X****XX**X*X***XX*XX**XX***X*X*X***X**X*X***XX*X**X***X*X****X*X*****X**X
*XX***X*X*****X**X**X*X*XX**X**X*X**X*X***X*X***X***XX*X**XX***X*X****XX**XXXX*XX*XXX*X*******X**X**X***X*X**X*XX***X**XX****XXXX*XX***X**X**XXX***X**XX**X***XXX****X**XXX**X*X*X***X*XXX**XX
*XX*XX****XXXX**X*X*X**X**X*XX*X**X***X*XX***XX*XXXXX***X***XX****X*X*X**X****X******X*XX*X*X**X*XX*XX*X*X*X***X*X*XX*X**X*X**X***X*XX*X*XX*X***X*X**X***XXXX***XX*X*X*X***X*XX**X*X*X*****XXX
*X**X**XXX****X*X****X***X******X*XX*X*****X**X*******X*X*X***X*X*XX**XX***XX***X*XX*X***X***X*X***X***X****X*X********X*X*XXX**XX*****X******XX**X*XXX*XXX***XX****XX**X*X****X**X***XXXX**XX
**X***X**X*X*XX*X*XX**XX*X*XXXXXX***XX*XX*X**X**XXX*X**X***XX**XX**X*X**XXX**X*X*X***XXX***XX*XX*X***XX**XX****X*XXX*XX***X****X*X*XX*XXX*XX*X***X***X**XX**X**X*XXX***X****XX*XX*X*X*****X**X
X**XXX**XX*X****X***X**X**X******XX***X**XXX*X*X***X**X**X**X*X***X**X*XX***X**X*X*XX***X*X*****XX*XXX*XXX*X*X*X*X**X*X*X***XXX**X*X*XXX*X***X*XXXX*X**X***X**X**X*X*XX**XXXXX**X***XXXX*X*X*X
XX*X**X****XXX*XXXXX*X**X**X*X*X***XX**X**X**XX**X**XX**XX*X**X*X*X*X*****X*X*X**X*X**X**X*X*XX*X***********X**X***X*****X*X***X***X**X**X*XX**X*XX***X**XXX*XX*X**X**X*X***X*X*X*XX****X****X
X**XX*X*X*X***XXX******X*X*X**X**X***X**X*X*X***X*X*X**XX**X*X***X**X*XX*XX**X**XX*X*XXX***X**X**XX*XXXXX*X***X**XX**XXXXXX**X***XX*X***X**X**X*****XX**X****X**XX**X*X***XX**X**X***XX***XXXX
**X*X*X**X**X**X**XXXX***X***X**X**XX*X*X*X*X*XX**X**XXX**X****XXX*X**X*X**X***XX**X**X**X***X*X***X*******X*X**X***X****X**X**XX***XX*X**X*X*X*XX*XX**X**X*X**X***XX**XX****X*X***XX**XXX***X
*X*****X*X*X*X***X****XX**XXX*X**XX*****X*X***X*X**X****X**XX*X****X*X***X**X*X***X*X*XXX*X*X**XXX*X*XXXXX*XXX*X**XX**XX**XX**X***X**X***XX*X*X***X***X*X*X*X*XX*X*X*X**XXXX*X**XXX**X***XX*XX
*X*X*XX**X***XX*X**XXX***X****X*X***XXXX***X*X****X*XXX*XX***X**XXX**X*X**X*X***XXX********XXX***X*X*X***XX***X**XXX*X**X***X**X*X*X***X*X**X*XX*XX*XXX****XX****X****X****X**X****X***X**X**X
*X*X*X**XXX*X****X****XX*X*XX*X***XX***X*X**XX*X*X**X*X***X*X**X**X*XX**X****XXX***XXXXX*X**X*XX***X***XX***X*X*X*X**X*X*XX**X*XX***XXX****XX***X***X***XX***XXXX*X*X**XXX**X*XX*X**X*X*X*X*XX
*X*X**X**XXX**XX**X*X******X**XXX*X*X*X***X***X**XX****XX**X**X**X****X**X*X***X*X******X*X****X*XX*XXX***XX**X***X*X****X*X*X****X****XXX*X*XX*X*XX**XX*XXXX******X**X***X*X**X**X*X***X*X**X
*X**X**X**X**X**XX***X*XX*X*XX***X******XX*XX**X**XX*X*X**X**X*X***XX**XX*XX*X***X*XXXX****X*X*X*X******XX*XX*X*X***X*XX***X**XX*X*X*X***X*X**X*X**X*XX*****X*XX*X**X**X*X***X***X**XX*X****XX
*XX**X**X*X*X*X****X**X**X*****X***XXXX*X***X*X*X**X*X**X**X*X*X*X*X*X******X**XX*X****XXX**XX*X**X*XX*X*X****X*XXXX*XXXX*X*X***X***X*XX*X***X***X*XX***XXX***XX**XX*X***X*XXXXXX*X**X*X*XX**X
***XXXX*X***X***XXX*X***XX*XXXX*X*XX****X*X*X*X**X***XXXXX*X****XXX***XXXXX**X**X***XX****X****X*XX***X****XXX********XXX****XX*X*X****X*XXX**X*XX****XX**X*XX**X*****X*XX***X****X*X**XX**X*X
*X***X**XXXX**XXX****X*XX**X******X**X*X**X*X**X***X****XX**X*X**X**XX****XX***X**XX*X*X*X*XXX*X***XX**XXX****XXXXXXX**X**XXX*X**XX*X*XX***XX*X***X*X***X**X***XXXXXX*****XX*X*X*XX***X***X**X
**XX*X*X*****X****X*X*X***X**X*XXXXXXX*X*X***X**XXX**XX***X*XX**X**XX**XX***XXXX*XX****X*X*X**X*XX***X****X*X*X******X***X*****X*X**X***XX***XX*X**X*X*X*X***X**X****XXX*X*X***X***X*X**X*XX*X
X*XX*X***XXXXXX*X**X**X*XXXX**X***X***XX**XX*XX****X***XX*X****X**X***X**X*X****X***XXXX****X*****X*X**XX*XX**X*X*X*X*XX*XX*XX***X*X**X*X*XX*X**XX*X*X*X**X*X*X***X*X***X***XXX**X*X*X*X*X***X
*X***X*XXX***X***X***X**X*X**XX*X*X*X***X**X***X*X*X*XX*X**XXXX**X*X*X**X***X*X***XXX***XXX***XX*X**X*X*X***X**X***X******X*X*XXXX**XX*****X*X*X***X***X*X**X*XXXXX**X*X**X***X*XX**X**X***XXX
***XX******X**X*X**XX**X**X*X***X*X**XX**X**XX**X***X*****XX****X******XX*X***XXX*X***X****XX**XXX*XX*X**XX*XX**XX***X*XXX**X*****X**X*XX*X**XXX*XX*XX*****XX******X*X**X**XX***X*X*X*X**XX**X
*X**XXXX*XX*X***X*X***X*X*X*X*XX**X*XXXX**X***X*X*X***X*X****X*X**XXXX*X**XX*X***XX*XX*XX*X***X****X***X**X***X*X**XXXX****X**XXX***X****X**X****X****X*XX*X**X*XX***XX**X*X**XXX***X*X*XX**XX
**XX****X****XX**X**X*X***X****X*X***XXX*XXXX*X**X*X*X**XXXXX**X*X****X**X***X*X****XX**X**X*X**XXX*XX*X*X*XX*X**X***X**X*X*X*X**XXX**X*X**XXX*XX**XX**X**X**X****X*X***XX*X*X***XX***X*X**X*X
X****XX*X*XX*X**X**X***X*XXXXX*X**XX**X**XX****X****XXXX*****XXX*X*X*X**X**XX**XXX*X***X*X*X*X*XX****X***X****XX**XX*X*X*XX****X****X**X**X*X****X***X***X**X**XX**X**X*X**XX**X***XXX****XX*X
**X*X*X****X**XX**X**X***XX***X*X***X*X*X***XXX*XXX**X***XXX*X****XX**X**XX*X*X***X**X*X*X**X****X*X*XXXX**X*X**X*X*XX*X****XX*XX*X**X*X*X***XXX*X*X**X*X**XX*X**X**X*X*X*X***X*XX*****XX*X**X
*X*****X*X**X****X**X**X****X****XX***X***X********X***X***X***XX****XXX********X***X*****X***XX***X******X***X********X*X*X*******X*X*****X*****X**X*X***X*****XXX***X*X***X*****X*X*X******X
