*X**X***X*X*X***X*******X**X***X*X***XXXXX******X*X*XX***X******X***X*XX*****X*****X****X**X*****X*****X******X****X******X*****************XXXXX******X********XX*X**X***X****X*X******X****X
***X**X*******X*X*X*XXX**X***XX****X**XXX**X*X*X*******X***XXXX**X*X*****XX*X**XXX***XX*X*X**XXXX**XXX**X*XX*XX*X*X**XXXX*X*X*X*XXXX*XX*X*X**XXX**X*XX**X*X*X*X*****X***X**X*X****XXXXX**X*X*X
X*X**X*XXX*XX**X**X***XX***X*X**XXX*X**X**X**XX**XXX*XX*XXX****X*X*X*X*XX***X*X****X**X*X***X*****X***X****X****X*X*X***X*X**X*X***X**XXXX*X**X**X**X*X*XX**X**XXXX***XX**X***XXX******X**X**X
**X*X**X*X**XX**X**XX***XX**X**XX***X*X**X*X****X****XX****X*XX****X**X***XX**X*XXXX*X**X*XXX*X*XX**X**XXXX*X*X*X***X*X*X**X*X***X**X***X***X**X**X*X*X***X**XX***XXXX*X*X**XX***XXX*X**X***XX
X***XX****X***X**X***X*X*XX***X***X*X*X*X***X*XX**XXX***XX******XX**X*X*XXX**XX*****X**X******XX***XX*X******XX*X*XXX*X*X*X**X*XX*X**XX*X*X*XX**X*X*X**XX**X***XX****X*X**X*X**X*X**X*X**X*X*X
**XX***XX**XX*XX**XX*X*X***X*X**XX**XXX**X*X*X***X***X*X***X*X*X*XXX**X*****X**X*XX*X*X*X*X*XX***XX****X*X*X*X***X****X*X*XX*X*X****X*X***X**X*X*X**XX*X*X*XXX*XXX*X****X***X*X***X****X***X*X
*X***X*X**X*X**XX**X*X**XX****X*X*X****X*****X*X*XXX****X*X***XX*****X*X*XXX**X*X***X****X***X*XX*X*XXX**XX***XX**X*XX**X******X*XXX***XXX*X*X*****X*****X***X**X***XX*X*XXX*X**X**XXX**XX*X*X
***XX*X**X***X***XX***X*X**X*X**X**XXX*XX*X*XX**X***X*X**X**XX***XXXX***XX**X****XX**X*X**XX***X***X****X***X*X*X***XXX**XXXX*X**X***X*****X**XX*XXX*XXX*X*X**X*X*X*XX***X*X***X*X***X*X*X***X
XXXXX***X**X**XX**X*XX**XXXXX**X**X**X**X**X***XX*X**X*X**XX***XX***X*X****X**XX***X*XXXX***XX*X*X*X*X*X**X*X****X*X*X*X*X***X**X**XX**X*X*X*X*XX****X*X**X*X*X**X****X*X***X*XX**XX******XX*X
***X**XX**X*X*X**X**X**X***XX*XXX***X*X***X**X*X***X*X**X**X*XX***X*X**XX*X**X**X*XX***X*XX*X*X**X***XX*XXXX*XX*XXX******X*X**X**X*X**X*XX*X*X****X*X**XX***X**X*X*XXXX***X*****X***XXXX*X***X
X*X**X***XX*X*X*XX*X**X**X*****X**X****XXX**XXX**X*X***X**XX*X**X*X**X**X**X**X*X*X*XX*X**X*X***XX*XX*****X***X**X**X*XXX***X**X**X**XX***X**X*XXX**XX***XX**X****X****X*X**XXX*X*X****X*X*XXX
X*X*X**X*X**X*X*X**X*X**X*X*XX***X*X*X*X***XXX**X***X*X**X***XXX**XX**X*XX*XX*X*X****X*XX***X*X***X***X*X*X*X**X*X*X**X***XX*X**X*XX****X**X**XX***X*X*X**XX**XXXX**XX**X**X**X**X**XX*X*X***X
**X*X*X**X*X**X**X*X*XX***XXX**XX***X**X*X**X**X*X*X**X*XX*XX****X*XX*X**X**X***XX*X*X***X*X**XXX***X*X*X*X*X*X***X**X**XXX***X*X***X*X*X*X*X*X**XX**X**X***X*****X*X*X**X*X*X*X**X***X***XX*X
*X***X**XX**X*XX***X****XX***XX***XX**X***XX**XX***X*X*X***XX*XXX***X**XX*X**X*X***X**XX*X**XX***XXXX**X**X**X**X**X*X*X****XX**X*X**X**X***X*X*XX**X*X**XX**XX*X***X***X**X***X*X**X***XXX**X
*X*X**X***X****X*XX*XXXX***X****X***XXX*X****X***XX****X*XX***X***X**X****X*XX*X*XX*X*X***X**X*X*****XX**X*X***XXX*X*X*X*XX**X*X*X*X**X**X*X**X***X***X*X***X**XXXXX**XX**X**X*X*X*X*XXX****XX
*X*X*X*XX*X*XX**X********XX*XXXX*XX****X**XXXX*XX***XXXX*X**XX**XX*X**XXX*X*X**X****X**X*X*X***XXXXX*X**X***X*X*X**XXX*X***XX**X****X**XX**X*X**X*XXX****XX**X**X**XX*X*X***X**X*X***X**X*XX*X
*X**X***X**XXXX***XXXX*XX*X*******X*XX**X*X***XX**XX*****X*X**X**X**X***X*X***X**XX**X*X*X*XX*X****X**X*X*X**X***X*****X*X**X*X**X*X*X****XX*X*XX****XXX***X**X**X****X**X*X**X**XXX***XX****X
*XX*X*X**X*XXXXXXX****X***X*X*X*X**X**X*X*X*X****X***X*XX**XX**X***X*X*X**XXXXXX*X*X*X*X*****X**X*X**X**X*X*X**X**X*XX*X**X***X*X*****X*X*X**X*X*XXX****XX*XX**X*X*X*X*X**X**X**X**XXX*X*X*X*X
****X**X*X**XXX****X*X**XXX*X*X**X***X***X**XXXX**X*X*XX**X**X**XX*X*X**X*****X****X**X*XXXX**X*XX**X*X*X*X*XX**X**X**X*X**XXX**XXXXX**X*X**XX*X****XXX*X****X***X**XX**X***X**X**X******X**XX
*XXX**XX**X**X**XX*X***X*****X*X*X*X*XX*X**X***X*X**X****X**X*X**X*X**X**XX*X*XX*XX*X******X*XX***X*X***X*X***X*XX**X****X***X*X*****X***X*XX**X*X*X**X*X*XXX**X**X***X***XX*X**X***XXXX**X**X
****X***X**X**X**X*XXX*X*XXX***X**XXX*****X**XX**X*X*X*XX*X****X*X*XX*XX***XX***X*****X*XX*X***XX*****XX***XX*X**X*X*X*X**XX*X***X*X**X*X**X**X*X***X*X**X***XX**X*XX**X*X***XX**XXX****X**X*X
XX*X*XX**X*XX*XX*X****XX*X**X*X*X**X**XX*X**X***X**X***X**X*X*XX*X**X***XX***XX*X*X*X**X***XXX**X*XX*XX**X**X***XX*X***XXX*X**XXX*XX*XX***X*X*X***X*X**X***X***X*****X*X**XX**XX*****XX*X*X**X
*X****X*X***X***X**XX*****X**X****X**X****X*XX*X**X*X*XXX***X*X***X*X*X***XX*XX*X*X**XX**XX***X*X**XX***X*X**XXX***X*X******X********X*XXXX*X**XX*X**X**XXX*XX*XXX*X*X*XX***X***XX*XX*X*X*X*XX
*XX*X*X**XXX*XX*X*X**XXXX***X**XXX**X**XXX******X*X****X**XX****X*X*X**XX**X****X*X*X**XX***X*X**X**X*X*X**XXX***XXX**XXXXX**X*XXX*XX*******X*X***XX**X*X*X**X***X*XX****XX*XX*X**X*****X*X**X
***X***X*X****X*X**X****XXX*X*XX***X**X***XX*XXX**X*XX*X*XX**XXX*XX*X*X**X**XX*X***X*X***XX*X*X*XX*X***X**X****XX***X*X****X**X***X***X*XX*X**X*X***X*X*****X**X*X****XX**X******X**X*XXX**X*X
*X**XX***X*XX*X*X*X**XX****X*****XX*X*X*X***X***X**XX**X*X**X*******X**X**X***X**X***XXX*X**X*X***X**X***XX*XXX***X*X**XX*X**X**X**X*XX**X*X*X***X*X****X*X**X*X*X*XXX**X**X*X*XX**XXX***XX**X
*XX***XX*X**X*X**X**X**X*X*X*X*XX****X***XX***X*X*X***XX*X*X**XXXX*X**XX*X**XX**X*XX***X***XX**XX*XX**X*X***X***X**X*X*X***X***X*X*X*X**X**X*X*X**X**XXX*X*X**XX*X*X***XXX**XXX***X*XX*X***X*X
***X*X*X*X*X***X**X**X**XX*X**X***XX***XX**XXX**X*X*XX***X*X*X****X**X***X*X***X****X*X*XXX**X**X***X**X**XX**XX*X*X*X*XX*X*XXX**X***X*X**XX**X*X*X*X******X*X***X*X*X**XXX*XX**XX******XX*X*X
X*XX***X*X**XX**X**X***X***X*X**XX**XXX***X**X*XX*X*X*XXX**X***X*X**X*X*X***X*XX*XX*X******X**X**XX***X**XXX*X*******X**X******X**XXX**X*XX**X****X*X*X*X*X**X*XX**X**X**X*****X*X*XX*X*XX*X*X
XX***XX**XX**XX***X**X*X*X**X**X***X****X***X**X**X*****X*XXX*XXX**X*****X*X*****X**X*XXX*XXX**X***XX**X**X**XXXXXXX**X***XX*X***X****X**X**X**X*X**X**X**XXX**X*X**X**X*XXX*XX**X*X*X*X***X*X
X**X*X**X**X***XX**X**XX**X*X*X**X***X*X*XX**X***X**X*X*X**X***X**X**XXX*X***XX*X*X*X***X**X*X**XX*X*X*XX*X*X*******X**XXX*X**X*XX*XX*X*X*X**X**X**X*X**X*****X***XX**XX***XX***X**X***X*X*X*X
**X**X*X**X*XX*X*X**X***X*XX**X*X*X*XXX****X**X*X**XXX**XX*X*X**X**X*X****X*XX*X**X**XX**X*****XX**X*X**X*X***XXXXX*XX***X**X**X***X*X*****X**X*X*X***X**XXX*X**X****X**XX****X**X*X*X*X**X**X
*X*X*X**X****X***XX**XX*X**X*X**X****X**X*XXX**X*X**XX*X*X*X*XX**X**XX*XXX*X****X***X***XX*X*XXX**X****X**X*XX****X***X*X**X**X**XX****X*XX**X**X***X**X*X*X*X*X*XXX*X*X**XXXX**XX****X**XX*XX
*X***X*X*X*XX*XX**XX**X**X*X**X**X*X*X*X***X**X***XX***X***X***X**X****X***X*XX*XX*X**XXX**XX****XX*XXX**X****X*X**XX*X***XX*X*X*X**XXXXX***XX*X*XX**X*X*X***X*X****X***X*****X*X**X*X**XX**XX
**XXXX***X*X**X*X**XXXXX*X**X**X**XX*X**X*X**X**X*X**XX**XX**X*XX**XX*XX*X***X****X**X****X*X*XXX******X*X*X*XX*X*X*X**X*X*****X**X****X**XX***X*X**X*X**XXX*X*X*XX***X*X*XXX*X***X*X**X***X*X
X*****XX*****X***X****X***X**X*XXX***XX*X*X*X**XX*X*X**X***XX****X**XX***XXXX**XX*XX**X*XX**X****XXXXXXX**X*****X*X**X**X**X*X**X**XXXXX*X*X*XX***X*X*X*X***X***X*X*XX***X****XXXX**X*XX*XXX*X
**X*X****X*X***X**X*X***X**X*******XX***X*****X******X***X****XX**X****XX*****X******X*****XXX*X*********X**XX*X****XXX***X***X**X***********X**X*****X***X***X*****X**X***XX******X**********
