*XX***X***XX**X**********X*******X*XX***X****X****X****X*******X******X*X*X*X********X********X*X**X***X******X****X***X*X*****X*XX****X*********X*X****X*****X***XXX*X*******X**X**X****X**XX
****XX**X****X**X*X*XXXX*X*X*X*XX*****X**XXX***X*X**XX***XX*XX***XX*X*X******XXXXX*X**X*X*XXX*X**X***X**XX*XX*X*XX*X*X*****X*XX*****XX*XX*X*X*XX****X*X*X*X*X*X*X**X****XXXXX**X***X**XX**X**X
*X*X*X*X*X*X**X**X*X***X*X*X**X***XX*X**X****XXX**X***XXX***XXXXX**X**X*XX*X********X**X**X*X**X***XXXX****X**X**X***XX*XX**X***X*XX*****X**X***X*X***X***XX*X**XX***XXX*****X***XX**XXXX**X*X
*X***X***X**X*X*X****X*X*X**X*X*XX****X***XXX***X*X*X*X*X*XX*X***X*X*XX**X**XXX*XXXX*X*X*X**X*XXX*X**X*XX*X**XXX**X*X*XX***X**X*X***X*XX**XX**XXX*X*X**X*X*****X***XX***X*XX**X*XX**X*XX**X**X
*X*X**X*X*X*XX**X*XXX*****X*X*X***XX*X*X*X***XX***X**X**X*X****X***X*X**XX*X***X*****X*X**X*X**X**X*X**X*X**X*X**X*X*****XX**X*X*XX**X*X*X***X***X***X**X**XXXX**X*X**X*X***X*X****X*****X**XX
*XXX*XX***X**X*XX****XXXXX**X***XX***X*XX**XX***XX**X**XX**XXX**X*X**X*X***X*X*X*XX*XX**XX***X**X*X***X****XX***X****XXXX***XX*****X*X*X*X*XX**X*XXX**X*X*X***X*X***X*X***XX**XXX*XX*X*XX**X*X
*X***X*XX*XX*X***X*X*****X*X*XX**X*XX*****XX**X*X**XX*XX**X***X*X*X*XXX**XXX*X**X*X*X*X*X**XX*X***X*XXX*XXX***X**XXX*X****X*X**XXX*X*X*X*X**X*XX***XXXX*X*XX*X**X*XX***XX**X*X***X****XX**X**X
XX*X****X**X**XX**X*XXXX*X*X***XX**XXXX*XXX**X***X****X**X**X**X**X**X**X****XX*X*****X*XX*X***X*X******X**X*X*XX***X**XXX****X***X**X*X*X*XX*X*XX*****X*****X*X*X***X***X*X***X*X*XX***X*X*XX
***XXXXXXX**X**X*X*****X*X**XX**X*X*X***X***X**X*XXXXX**X**X**XX*X**X**X**X*X***XX*XXXX******X*XX**XXXXX*X********X**X****XXXX**X***X****X********XXXX***XXXXX*****X*X*X**X*X*X**XX*XXX*X***XX
*XX*****X*X*X*XX*X*X*X*X**X***X*X*X***XX**XX*X*X*******X**X**X****X***X**X**X*XX*X*X***X*XXX**X***X****X**X*XXX*XX*X***XXX*****XXXXX**XXXXXXXX*XX*X***XX*X****XXXXX***X*X***X*X*X*****X**XX**X
*X**X*X***X*X*X**X**X*X*X**XX***X**XX**X*X****X*X*XXXXX**X**X*X*X*XXX**X**X*X**X*****X**X***X*X*XX**XX**X*X****X****XXX****X*XX*X***X****X***XX***X*X***X**XX******X*X***XX**X**X*X*X**X**XX*X
*X*X***X*X**X***X*X******X***X*X*X*XXX***X*XX*X**X******X**X*****X***X*XX**X**X**X*X*XX**X*X**X*X**XX*X****XXX**X*X*X***XXX*X*****X**XXX***X***X*X**X*X**X*X*XX*XX**XX*X*X*XX**XX*XX*X*XX****X
****XXX**X*XXXXXX***XX*XX*XX*****X**X**XX**X**XX***XXXXX*X**XXX*X**X****XX**X**XX*X****X*****XX*X*X****X*X***X*X**X***XX**X***X*XX*X****XXX*XX*X***XXX*XX**X***X*XX****X*****X*******X***XX*XX
X*XX***X*X**X*****XX*X******XXXX**X*X*X***X*X***X*X****X**X***X*X*X*X*X***X*XX*X***XXXX*X*X*X***X***XXX*X*XX****X*X*XX**X***X**X****XXX***X**X**XX**X*****X*XX*****XXXX*XXXX**X*X*X*X*XX*X***X
***X*X****X**X*XXX***XXX*XXX****X*X*X*X*XX***X*X**X*XX**X**XX***X****X*XX*X**X***X*******X***X*X*X*X********X*X*X**X***X*XXX*X**X*XX***XX*XX**X***XX**XXXX***X*XXX******X***X**X***X***X*X*X*X
*X*X**XXX**X*X***X*X***X*****XX*XX**X*X*X**XX**XX****X*XXX****XX*XX*X***X**X**XXX*XXXX*X**XXX**X**X**XXXXXX**X***X*X*X*X******X*X****X*****X*XXXX***X****X*X***X**XX*XXX**X**X*X*XXX*X***XX**X
*X**X*X**X*X**X*X**XXX**X*XX**X**X*X*XX***X***X***XX*X*XX**XXX***X**X*X**X**X*X*******X*X***X*X*X***X******X**XXXX***X*X*XX*XX**X*X*X*XX*X*X**X*XXX*XXXX**X**XX**X***X***X*X*X**XX***X*XX***XX
X*X*X**X***XX*X***X**X*X*X**X**X*X*****XX**X*XXXXXX**X***XX****X*X*XX*X*X*X*X**X*XXX*X***XX***X***X*X*X*XX**X*****XX*X*X**X****X**X*X***X****X****X*****X**X*X**XXX*X**XX****XX*X**XX*X**X*XXX
**X*X*XX*X**X*XXX**X*X****X**X**X*XXXX*X*X*X**X****X**XX*X**XX*X***X**X*X****X**X******X*X*XXX**XX**X*X**X*X*X*XX*X**X**X**XXX**X**X**X*X*X*X**X*X*XXX*XXX*X**X**XX**X***X*X**X***X****X*X*XXX
*XX*X***X*XXX***XXX***XXX***XXX*X****X***X*X*X**XX*X*XXX*X*XX*X*X*XX*XX**X*X**X***XXXXXX*X****X***X*X*XX*X****X***X*XXX**X****X**XX**X**X**X**XX*****X**X**XX**X***X**XX*X**X**XXX**XX***X**XX
*X***XX*X****XX****XX***XXX**X****X*X*X*X**X*X*X***X**X**X*******X***X*X**X*X**X*X********X*X**X*X**X**X**XXXX**XX***X*X**XX*XXX**X*XXX**XX**X**XXX*X*X***X***X**X**X****XX**X***X*X**XX*XX**X
*X*X*XX***X*X**XXX**X*XX***X**XX*XX***X***X**X*X*XX**X**XX*X*XXXX**XX***X****X**X**XXXXXX*X**X**XX*XX*X**X***X*X**XX***X*X***XX*X*X**XXX**X*X*X***X****X*X*XX**X**X**XX*X*XX**X*X**X*X*X***X*X
*X*X***X*XX**X****X*X****X**X***X***X*XX*X**XX*X***X**X*****X***X*X***X*X*XX*X*X**XX*****X**X*X*X**X***X***X*X**X****XX**X*XX***X**X**XXX*X****X*X*X*X*XX****X**X*XX***X****X**X**X****XXX***X
**X**XX*X***X**XX***X*X*X*X**XX*X*XXX***XXX*X**X*X*X*X*XX*X*X*X*X**X*X***XX**XX**X***XX*X**X****X*X**X*XX*X***X*X*XXX***X**X**X*X*X*X**X***X*XX****X**X***XX*X*X****XX**X*X**X*XX*X*X*X***XXXX
X**X****X*X**X***X*X*X**X**X**X*X****XX**X**X*X*X**X*X***XXX**X**X***X*XX***X***X**XX***X*X*X*X*X*X*X****X**XX**XXX***XX**X*X**X**X**X**X*XX***X*X**X***XX*X***XXXX**XX*X*X*X*****X**XX*X*X**X
*X**XX*X***X**XX**X***X**X***X**XXXX***XXX*X**X**X*X*X*X**X**X*X**XX*X**X*XX**XX*X*X*X*XX****XX*X**X**XX**X****X****XX***X***X*X*X**X**X**X**X*X*XX**XXX****XXX****X**X***X**XXX*X*X*X**X***XX
*XX**X*X*X**X*X**X**X*XX**X*XX*X****XX*X****X*XX*X*X***X*X**X***X***X**X**X**X*****X***X**XX*X***X**XX**X**XXXX**X*X***X*X*X***X***X**X*X**XX**X***X****X*XXX*X*XX*X*X*X*X*X****X******XXXX**X
*XXX*X*X*X*X**X*X**X***X*X**X**X*XX****X*XXX*****X**XX**X**X**X**X*X**X**X**X**XX*X**XX**X***X*X**X***X**X******X*X**XX*X**XXX*XX*XXX*X**X****X*X*X*X*X*********X**XX***XX*X*XX**X*XXXX*X***XX
*XX**X*X**X**XX**X**X*X***X***X**XXX*X*X****XXX*X**X**X*X*X**X**X**X*X**X**X**XX***X***X*X*XX*X*X*XXX*XX**XXXX*XX***X***X*X**X*****X**X*X*XXXXX**X***X**X*X*X*XX*X**X*X*****X**X*X*X****X*X*XX
****X***X**X***X**X*X**X*X*XXXXX**XXX**XXXX*****X*X**XX*X**XXX*XX*XX*X*X**XXX*X**X*X*XX**X*X****X***X***X*****X***X**XX*****X**X*X*X*X**********XX*X**XX**X*XX****X*X**XXXX***XX****XX*X**X**X
X*X**XX**X*XXXX**X***X*X******X*X**X**X****XXXXXX**X*****X*****X**X**X***X*X***XX**X***XXX**XX*XXXX*X*X*X*X*XXX*XXXX*X**XXXX*X**X*X**X*X*XXXX*X****XX*X**XX***XX*X**XX*X***XX***XXX*X***X**X*X
***X**XX*X****X*X**XXX**XX*XX*X**X*X*XXX*XX*******X**X*XX*XXXX*X*XX*XXXXX***X*X***X*XX****X**X*XX*X*X*X*X*XX****X*X**XXX******X*X**X*X*XXX****XXXX**X**X***XX**X***X***XXX***XX***X***X*X*XX*X
X*X*X**X**XXX*X**X****X***X*****X**X**X**X**X*XXX*X*XXX******X*X*X***X****X**X**XX****XXX*XX*X****X*X*X*X**X*X*X**X*X****XXXX*X**X*X*XX****XXX****XX*X**XX***X**X*XX*X***X*X***XX**XX*X*X*X**X
****XXXXX*X*X**X*X*XX*X*X**X*X*X**XXX*X*X**X*X***X***X**XX*XX**X**XX**XX*X*X**X**X*XX***X**X**XX*X***X**XX*X**X**X**X*X*X***X*XX***X****X*X**XX*X*****X**X*XX*X*X***X**X*X**X*X*XX***X**X**X*X
*X*X***X****X*X**XX*X**X*X*X*XXX*X*XX*X**X*****X**X*XX*XXX***X**X***X**X*X*XX**X*X***X*X*X***X***X*X*X*X****X*X*X**X***X*X*XX***XXXXXXXX*X*X**X*XXX*XX*X**X*****X*X*X*X**XX*X******X**X**X*X*X
*X***X**XX*X**X*X****X*X****X****X*****X**X*XXX*X**X***XX*XX*XX*XX*XX*X**X***X*X**X*X*X***X*X**XXX*XX**XX*XXX***X*X*XX*****X*X*X***X***X***XX*****XX***XX*X*XXXX*X***X**X****XXXXXX*X**XX**X*X
**X*XXX*****X*****XX***X*XX***X*X**X*X***X*******X***X*****X*****X******X**X*****X******X****X********X*******X*X******X*X***X***X***X***X****X*X****X******X******X***X**XX*********X****X***
