*X*X***XX*****XX********X***X****X***XX*X***********X******X*X***X**X***X**X************X******X***********X*******X***X**************X*X***X*X******X***X*X*****X*******X********X****X****XX
*X***X****X*X***XX*X*X*X**X*X*X*X**X******XX*X*XXXX*XXXX*X*X***X***X**X**X**XX*XXXXXXXX***XX*XXX*X*XX*XXXX*XX*XXXX***X**X*XXX*XXXX*X*X****XX**X*X*XXX**X****XXX*X**X*XXX**X*X*XX*X**XX***XX**X
*X*X**XXXXX**XX***XXX****X**X*X**X**XX*XXX**X*X***X****X*X***XX*X*X**X*X**X***********X*X***X****X***X***X***XX***X*X*X**XX***X**X**X**XX*X**X**X*X***XXX*X*X****X*X****X**X**XX**X*X*XX***X*X
**X**X*****X*X**X**XX*XXX**XX**X**X*XX***XX*****X*XXXX***XXXX***X**XX***X***XXXXX*X*X*X*XX*XX*X*X**XX**X**XX*X**X*X****X****XX**X**X**X*X***X**XX*X*XX*X**X***XX*X*XX*X**X**X***X***X***XX*X*X
X***X*X*XX*X*XXX*X****X**X***X**X*X***XX**X*XXXX******X*X***X*X**X****X**XXX*****XX**XX**XX****X**X***X*X**X***X**X*XX**XX*X*X*XX*X**X***XXX**X***X*X**X*X*XX*X**X***X*X*XX**XX**XXXXX*X*X*X*X
X*XX**X**X*X*****XXX*X**X**X***XX**XX**XX*X*X***XX*X*XX*X*X**XXX**X*X**X*****XXX***X***X****XXX**X**XX****X*X*XXX**X***X*XX*********X**X*****X**XX****X**X***X**X*XX***X**XX**X*X***X****X*XXX
**XX*XX*X**X*X*X****X**X*XX*XXX**X***XX***X***X**X*XX***X**X*XXXX****X*XXXX*X**X*X*X*XX*XX*XX***X*X**X*XX*X**X*X**X**XXX****XXXX*X*X**XXXXXX**X****XX*X*XX*X**X*X**X*X**X***X*X*X*X***XXX****X
*X***X**XX*XXX**X*X*X*XX****X**X**XX****XX*XX**X*X**X*XX**X***XX**XX**X****X*X**XX*XX*****X***XX***X*X**X***X****X**XX***XX*X***XXX**XXX****X**XX*X**X**X**X*X***X***XXX*X*X*X**X**X*X***X*X*X
***X*X*X******XX**X*X***X*X*XX*XX***XXXX*X***XX***X*****X*X*X***XXX**X**XX****X*******X*X**X*X*X*X**XXX*X*X*X*X*XXX***XX*X****X**X**X*X**XX**X***X*X***X**XXXX*XX*XXX****X****X**XX**X*X*X*X*X
X*XX*X*XXXXXX***XX**X*X***X**X****X****X***X****XX*X*XX*X**XX*X****XX**X**X*X**XXX*XXX*X*X***X***XX**X***X**X**XXX*XX***X**XXX*XX**X**X*X*XX**XXX***X*X*X**X***X******XX**X*X**X**X*XX*X**X**X
*X***X******X*X**X*X***X*X*X**X*XXX*XXX**X**X*XX****X****X***X*XXX*X**X*X**X**X***X*******XXX*X*X*X*X**X**X**X**X***X*X*XXX*****X*XX*X******X*****X***X**X*X*XX**X*X*X**X**X**X*X***X**XX**X*X
**XX**X*XXX**XXX***X*X**X***X*XX****X***X*XX***X*XX**XXXXXXX*X***X*X*X***X*X*X**X**X*XXXX*X*****X****XX*X**XX**X**X*XX******XXX*******XX*XX**XXX*X*XXXX*X**X**X*X*X*X*X**X*XX***XXX*X*X**X*X*X
X****XXX***X**X*XXX***X**XX******XX*X*X*X***XX*X***X*****X***XX*X****XX*X**X***X*X**X***X***XX*X**XX*****X**X*X**XX***XXX*X****X*XXXX***X**X***XX**X******X*X*X********X*****XX*****X**X*X***X
X*XXX*X**X**X*****X*X**X*X*XXXXX**X*X**X**X***X*XX**XX*X*X*XX****XX*X****X**XXX***X*X*X**X*X*XX*X*X*XXXX*XX*X*XX*X*XX****X*XXX**X****XX**X**XX***X***XX*X*X***X*XXX*XX**X*XX*XX*X*XX**X***XX*X
**X***X*X**X*XX*X*X**X*X********XX***X*X*X*XX*****X***X****X*X*X***X**XX***XX**XX***X**X*X*******X*****X****X****X*X*X*X*X*****X**XX*X*X***X**XX**XX***X*X**XXX****X**X**X*****X****X*X*X**X*X
*X**X***X*X****XX**X**XXXXXX*XX***XX*X*X*X***X*XX*X*X*X*XXX**X*XXX***X**XX****X***X**X*X*X*XXX*X*X*XXXX*XXX**XXXX*****X**X*XXXX**X***X**X*X**XX*X*X*X*X****XX**X*X*X*XXX*X*XXX**XX*X**X*XX***X
**X*XXXX****XXX***X*X**X****X**XX**X*X*X***X*XX****XX**X****XX****X*XXX*XXX*X*X*XX*XX**X**X***X**X********X*X****X*X*X**X**X***X*X*XX*X*****X*****X***X*XXXX**X*XX***XXX**X***X***X**X****XXXX
X**X****XX*X****XX**XX*X*XX**X**XX**XX**X*XX***XXX***X*X*XXXX**X*X**XX***X**XXX**X****XXX***X*X*X**XX*X*X*X**XX*X***X**X**X**X***X*X***X*XX*X*X*XXX*X*X*X****X****XX**X*X***X*X*X**X**X*XX***X
*X***XX*X**XX*XXX*X****X***X**X***X***X*XX**XX****XX***X*X****X*X**X***X***X***X**X*XX*X*XXX**X**X***XX**X*X*X**X*X**X*X*X**XXXXXX***X**XXX*X**X***X**X*X*XX**X*X**XX*X**XXXX**X**X*X**X***X*X
**XXXXX*XX**X*X***X*XXX*X*XX*X*X*XX*X*****X***XX*X**XXX**X*XXX**X*XX*X**XXX**X*XX*X*X******X*XXX**XX***X***X***X**XX****X**XXX****XXX*X**X***X***X*X*X**X**X*X***X**X*X*X*****X**X****XX*XX**X
X****X****X*X*X*XX********X**X***X*X**XXX**XX**X**X*X***XX*X***XX***X*XX****XX****X**XX*XXXX**XX*X**XX**X*XXX*X**X**XXX*X*X*X**XX*X****X**XX*XXXX**X*X*XXX**X**X**X*X***X*XX*X*X**XXX****X**XX
**XX***XX***X*X****XXXXX*XX*XXX*X**X*X***X****X*X*X***X****XXX***XX*X****X*X**XXX**X*X**X***X****X*X**X*X*XXX*X*X*X***XX**X***X****X*X**X*XX*****X*X*X*XX*X***X*XX***XX*X***X***X****XXX**X*XX
X***XXXX*XXX**X*XXX*****X****X**X*X**X*X**XXXX****X*X**X*XX****X**X***XXX*X*X****XX**X*XX*X**XX*X****X**X**X**X*X***X****X*XX**X*XX***X*X***XXXXX**X*X*****X*X*****X*X***X*X**X*XXXX****X*X**X
**XX********X*X***X*XXX*X*XX***X**XXX***X******XXX*X*X**X*XX*X**X*XXXX******X*XX****X******X***X**X*X**X*X***XX*X*X*XXX*X****X*X***X*X***XX*X*****X***XXXX*X*XX*X*X**X*XX**XXX******XXX*X**X*X
X**X*XXXXXX*X*X*X*X***X*X*XXXXX*X****X*X*XXXXX*X******X*X****XXX*X****X*XXX****XX*XX*XX*X*X**X***XXXX*X***XXX****XX****X**XX*X*X*X*X*X*XX***X*XXXXXX*X***X**X***X**X*X**X*X***X*X*XX*****XXX*X
**X**X******X**XX*X*X*X*X**X*****XXX*X*X******X**XX*XX**X*XX*******X*XX*X**XXX**X*X*****XX**X*XXX*X*****XX***X*X*X**XX*X*X***X**XX**X***X*XX**X***XX***X**X*X*XXX*X**XX*X***X*XXX****X*XX****X
*X**XX*X*XXX*X*X***XX*X**X*X*XXX*****X**X*X*X**X*X**X**X**XXXXXXX*XX****X*X***XX**X*XX*X*X*X********XX*X***X**XX**XXXX***XX*X*X*X*X***X*X****X**X****XX**XX*X****X**X****XXXX****X*X**X***XXXX
X**XX***X*******XXX****X**XX***X*XXXX*X*X*X*XX**XX*X**XX*X*X*****XX*XXXX****X**X*X*XX**X*X**X*XX*XXXXX*X*XX*X***X***X**X**X***X*X*X*XX***XX*X**X*X*XX***X***X*XX*X*XX*XX*X***X*X**X**X**XX***X
**X***X***XX*X*X****X*X*X*X*XX**X*****X****X***X***XX*X**X***X*X****X****XXX**X**X****X***X*****X***X**X*****XX**XX*X*X*XX**XX**X**X***X**X*X*X**X*X**X*X*XX**X**XX***X*X**X*X**X*X*X**X***X*X
*X*XXXXXXX****X**XXX*X**X*****X***XXX**XXXX**XX**XX***X*X**XX**X*XX***X*X***X**X*X*X*XX*X**X*XXX**X*XXX*X*X*X***X*X**X*****X***XXX***XX*X**X****X**X*X*X**X**X**X***XX**X*X***XXX*X*XX*X*XX**X
******X****XXXX*X**X***X*XXXX**X*X***X*****X**X*X*X*XX**X*X***X*X**XXX*X**X*XX*X*X**XX***X**X****XX*****X**X**XX***X**X*XXX**XX*XX*XX****X*X*X*X**XX*X*X*XX*X*X***XX*X*XX**X*X****X**X*****X*X
*X*XX**XXXX******X***X***X**X*XXX**X**XXXX*X*X**X*X***X**X**X*X***X******XX**X*X**X***X*X**X**XXXX*X*X*X*X**X*X**X***X**X***X*****X***X*X**X**X**X*****X***X**X*XX*****X**X****XXX*X**XXXXX**X
**X**X****X*XXXXX**X**XX*X*XX**X**X*X****X***X*X***XX*XX**XX**X*X**X*X*XX***X**XX**XX*XX**X**X******X****XX*X**X**XXX**X*X*XX*XXX***XXX**X**XX**X*XX*XX*XX**X******X*XX**X*XX*XX***XX******X*X
X*X*X*XXX*X*X****XX**X*****X*X**X*X*XXXX**XXX****X**X***X*X**XX*X*XX*X*X**XXX*X**X*X*****X**X**XX*X*X*X*X***XX*XX*X***X****X**X**XX*X**X**X***X*X********XX**X*X*XX***X*X***XX***X***XXX*X*X*X
**X*****X*X*XX*X*X**X*XX*XX***X*X*X*****X***X*XXX*X*X*X*X**X*X**XX***X**XXX*****X**XXX*XX**X**X****X**XXX*X**X*****X*X**XX***XX*X**X**X**X*XX***X*X*XXXX***X*XXX**XXXX**X*X****XX*XXX***X**X*X
*X**XXX*X****X*X*X*XX*******X*X****X*XX**X*XX*X***X**X***X***X*X***XX*X*****XXX*X*X***X***X**X*XX*X**X*****XX*XXXXX**X*X**X*X***X*X**X**X****XXX*X*X****XXX*****XX*****XX*XXX*X*******X*X*X**X
***X*****X*X***X***X**X*XX*X***X*X*****X*X******X**X***X**X*X****X*****X*X*X****X***X***X***X******X***X*X**********X****X****X*****XXX***XX*********XX*****X*X****XX*X*****X***X*X*X*X*******
