*****X*****X*******X***X*X***XX***X***XX*X******X****X*XX**X***XXX******X******X***********X***X*X*******X****X****X***X****XX***XX***X*******XX*****X
X*XX***XXX***XX*X*X**X****X*X***X***X****X*XX*X*X*X*X****X***X**X**XX*X*X*XXX*X**XXX*X*X*X**X*X****X*XX*X**X*X**X*X**X**X*X***XX****X**X*X*X*X***X*X*X
****XXX***XXX**X**X*X**XX***X*XX**XXXX*X*X*X**X*X*X*X*XX**X*XXX*X*X***XX**X***X*XX*X**X***X***X*X*X*X***XXX****X**X*XX*X***XX***X*XX*X*XXX**X**XX**X*X
XXX***X*X*X*X*XX*X***XX**XX*X**X*X**X***XX**X**XX*X*X*XXX*X*XX***XX*X**X*X**XX**X***X*X*X**XXX**X*X***XX***XX*X**X****X**X*X*XX***X**X****X***X*X*XX*X
***XX*X**X****X***XX***X*X****X***X***X***X**X****X*X**X**X***XX*X**X*X***X*X**X**XX**X*X*X****X**X*XX*X*X*X**XX**XXX***X**X***XXX*X**X*X*X*XX**X*X**X
*X*****X***X*X**X***XX*X**XXXX*X*XXXXX*XX*XX**XXXX**X*X**XXXX*X**X*X**X*XX**X*XXX*X**X***X**XXX*X*X**X***X**X***X***XX*X**X**XX*****X**X**X***X*X**XXX
**XX*XX**XXX***X*XXX***XX****X*X**X*****X**X*X*****X**X*XXX***X*X***XX**X**X***X**X*X**XX**XX*X*X**X**X*X**X**X**XX***X**X**XXX*X*X***X**XX*X***XX***X
X***X***XX**X*XX*****XX***XX****X***XXX*XX*X**X*X*X**X***X**X*X**XX*X**X**X*XX**X*X**XX***XX*****X**X*X**X*X*X**X***X*XX*X*XXX***X*XX*X*X****XX***XX*X
**X*X*X****XXX***X*XXXXX*XX*XX*X**XX**X***XXX*X**X**X*XX*X*X*X*X**X***X**X****X*X**X****XX***XX*X**XX*X*X**XXX*X*XXXX****X**X**XX*****X*XX*XX***XX***X
*XX**XXX*X**X**XX*X**XX**X***X*X*X***X*XX**X**X*X**X***X*X*X***X*X**X*X*XX*X*XX**X**XXXXXX*XX***X*X***X**X*****X*****XX*X*X***X***X*X*X***XX**XX***X*X
***X**X***X*X*XX***X****X**XXX**X**X***X*X***X**X*XX*X*X*X**XX***X*X*XX***X****X*X*X****X**X**X*X**XX**X**X*XX*X*XXX**XX****XXX*XX***X*XX***X**X*XX**X
XX**X**XX*XXX****X**X*X*X*X***X***X*XX*X**XXX**X****XX*X*XX***X*X*XX****X***X*X**X***XX***X**X***X***X*X*XXX***X*X**X***X*XX****X*XXX****XX*XX*X***X*X
***X*X***X***X*XX*X**X****X*X**X*X******X*X**X**XXX****X***XX*X*****X*XX**X**X**X**XX*X*X**XXX*X*X*X*X*X**X**XX**X*X**X*X***X*XX****X*XX**X***X**X*XXX
*XX**X*XXX*X**X***X*X**XX*X*X*XX**XXX*X*X**X**X****XX*X*XX*XX**XXXX*X***X*XXX**X**X****X**X***XX**X**X**X**XX***X**XXX***XX*X**X*XX***XXX**XX**X*X***X
*X**X******X*X**X*X**X**X*X*X***X****XX**X***X*X*X**X*X**X***X****X*X*X**X****XXX*X*XX**X*X*X***X*X*X*X**X**X*XX**X***XX*X***X***X*XXX*X*X***X**X**X*X
*XX**XX*XXX****X**XX**X**X**XXX**X*X***X*XXX****X**XX***X*XX**X*X*X**XX*X**XXX*XX*X***X**X**X*X**X**X**X*X*XX****X**X*X**X*XX**XX********X*XXXX*X*X**X
*X*X***X****X*X**X**X**X**X***XX*XXX*X*X*****XX**X*X*XX***X*X*X*X**X****X*X********XX**X*XX*X**X***X**X**X****X*X**XX**X**XX**X***XXX*XXXX***X**XX**XX
****XX*X*X*X***X*XX**X**X*XXX**X****X**XX*X*X***XX***X**X***X**X**XX*XX*X*XXX*XX*X**X*XX**X*X*X*XXX*X**X*X*X*X*X**X**X**X***X**X*X**X*X***XX**X***X**X
X*X**X*X**X*XXX***X*X**XX****X**X*X**X**X**X**XX**X*X**X*XXX*X**X***X***X****X*X**X*X*X**X**XX*******X*X*XX****X*X**X**X**X*X*X**XX*X*X*X*XXX**XX*X*XX
*X*X*X**X*X****XX***XX***X*XX**X*X*X**X*X*X**X*X*XX***X******X*X**X**X*XXX*X*****XXX**X*X**X***XXXXX*X*X***X*XX**X*XX*X**XX*X**X**X*X***X**X*X****X**X
*X*X*X*X**X*XX***XX***XX*X**X*X*****X*X**X**X****X**XX**XX*X*X**X*XX**XXX***XXXX**XX*X**X*X**XX****X*X**XX*X**X*X*****X*XX**XX**X*X**XXXXX***XXXXXXX*X
*X*X*X*X*X**X*XX***X*XXX**XX****X*X*X*XX**X**X*X**XXX**XX*X**X*X****X**X**XX****XX***X*X***X*XX*X*X**X*X*X**X*X*XX*X*X*X***X***X***X*X**X*X*X*****X**X
*******X**X*X***X*X***X*X***X*X*X**X****X**X***X*X****X***X*X***XXX**X***X***X*X***XX**X*X*******X**X******X**X***X******XX*X*X*XX*****X**X***X*X*XX*X
X*XXXX**X*X**XX*X**XX****XX**X**XX*X*XX***XXXXXX*X*XXX*X*XX**XX****XX*XXXX*XXX***XX***X*X**XX*X*X**X*XX*XXX**X*XX*X*XXXXX********X*XXX***X*X*X**X**X*X
**X***X*X**X*X***X**XX*X*XXX**X**X**X**XX**X****XX***X*****X**X*X*X********X**XXX***XX****X***X*X*X*****X***X***X**X****XX*XXX*X**X***XX****X*X**X***X
XX**X*XXX*X**X*XX*X***X***X**X*X*XX**X**X*X**XX***XX*X*X*X**X*XX**X*XXXXX*X*X****XX***X*XX**XX**X**X*X*X**XX**XX*X*X*XX***X***X*X*X*X***XXX***XX**XX*X
***X******XX*X*X***XX**XXX**X**X***X**X***X*X**XX**X**XX*X*X*X***X**X****X****XX***X*X****XXX**XXX**X**X*XX*X****X***X*XX***X***X*X**XX****XX***X***XX
*XXX*X*XXX***X***X***X*****XX*X*XX**X**XXXX*X*X*X*XXX****XX**X*XX**XXX*X*X*X*XX*X*XX*X*XXX***X**X*X**X*X*****XX*X*X*X****XXXXX*X***X*XX*XX**X*X*X*X**X
****X*X****XXX*XX**X**XXXXX*****X**X**X*****X*X*X**X*XXX****X***XX**XX**X**XXX****X**XX****X*XX****X*X**XXXX******XX*X*X****XX**X*X****X**X**X***XXX*X
X*X*X***XXX******XX*X*X****X*XXX**X**X**X*XXX****X******XXX*X*X***X***X***X****X*X**X***XXXX***XXXX**XX*X****X*XX*******X*XX***X**XXXX*X*XXX**XX**X**X
**X*X*XX**X*X*X*X***X**X*XX******X*X***XX****XX*X**X*XX***X****X*X**X*X*X*X*XX*XX**X**XX****XX*X****X*X*XX*XX*X**X*XXX*X*X***XX**X*****X**XXX*X*X*X*XX
*XX*X**XX***X**XX*X**X******X*XXX***X*X**XXX*X***XXX***XX*XXXX**X**XX**X**X**XX***X**X*X*XX**X*X*XXXX*X***X****X**X**X***X*XX*XX***XXXX*X**XX*X***X**X
X****X***XX**XX****X*X*XXXXX*****XX**X*X*******XX***XX**X*****XX**XX*X**XX**X***XX*X*X*X**X*X****X*****XX*X*XX**X***XXX*X**XX***X*X******X****XX*XXX*X
**XX**XX***XX***XXX**XX*****XX*X**X*X***XXXXX*X***X*X**XXX*XX***X*X**X*X***X**XX*X***X*X*XX**XXXX**X*XX*X*X**XX*X*X**X**X*X***X**X*X*XX*XX*XXX***XX**X
X**XX***XX*X**XX****X***XXX**XX*X***X*X*X****X**XXX*XX**XX*X*XX*X***X**X*X*XX*X****X*X*X***X****XX**X***X*XX**X**X*X***X**X*X**X*******X***X**XXX***XX
*X***XXX*****X*X*XXX**XX**XX*****XXX**X***X*XX*XX*****XX***X*XX*XXXXX*X***X****XXXX**X*X*XX*XXX**XX*X*X*****X**X****XXX**X***XX*XXXXX*X**X***X****X**X
***X*****XX*X********XXXX****X*X*****XXX*X*****X**X*X****XX***********X*X***XX******X**********X*******X*XX***XXX*X*****X**X********X***X**X***XX**X**
